1111111111111111
1122222222222221
1122222222222221
1122222222222221
1122222222222221
1122222222222221
1122222222222221
1111222111112221
1122222222222121
1122222222222221
1111111111111111
