62,62,62,62,62,62,62,62,62,62,62,62,62,62,62,62,
62,63,3,3,3,3,3,3,3,3,3,3,3,3,3,3,
62,3,3,3,3,3,3,3,3,3,3,3,3,3,3,3,
62,3,3,3,3,3,3,3,3,3,3,3,3,3,3,3,
62,3,3,3,3,3,3,3,3,3,3,3,3,3,3,3,
62,3,3,3,3,3,3,3,3,3,3,3,3,3,3,3,
62,3,3,3,3,3,3,3,3,3,3,3,3,3,3,3,
62,3,3,3,3,3,3,3,3,3,3,3,3,3,3,3,
62,3,3,3,3,3,3,3,3,3,3,3,3,3,3,3,
62,3,3,3,3,3,3,3,3,3,3,3,3,3,3,3,
62,3,3,3,3,3,3,3,3,3,3,3,3,3,3,3
