56,56,56,56,56,56,56,56,56,56,56,56,56,56,56,56,
56,56,56,56,56,56,56,56,56,56,56,56,56,56,56,56,
56,56,56,56,56,56,56,56,56,56,56,56,56,56,56,56,
56,56,56,56,56,56,56,56,56,56,56,56,56,56,56,56,
56,56,56,56,56,56,56,56,56,56,56,56,56,56,56,56,
56,56,56,56,56,56,56,3,3,3,3,3,3,3,3,3,
56,56,56,56,56,56,56,19,38,38,38,38,38,38,38,38,
56,56,56,56,56,56,56,19,56,56,56,56,56,56,56,56,
56,56,56,56,56,56,56,19,56,56,56,56,56,56,56,56,
56,56,56,56,56,56,56,19,56,56,56,56,56,56,56,56,
56,56,56,56,56,56,56,19,56,56,56,56,56,56,56,56

1
market

3
octorok-b 1 16 6
fat_dog-o 1 12 6
fat_dog-o 1 14 6
