68,68,68,68,68,68,68,68,68,68,68,68,68,68,68,68,
68,68,68,68,68,68,68,68,68,68,68,68,68,68,68,68,
68,68,69,15,15,15,15,15,15,15,15,15,15,15,15,15,
68,68,15,32,15,15,32,15,15,32,15,15,32,15,15,15,
68,68,15,15,15,15,15,15,15,15,15,15,15,15,15,15,
68,68,15,32,15,15,32,15,15,32,15,15,32,15,15,15,
68,68,15,15,15,15,15,15,15,15,15,15,15,15,15,15,
68,68,15,32,15,15,32,15,15,32,15,15,32,15,15,15,
68,68,15,15,15,15,15,15,15,15,15,15,15,15,15,15,
68,68,15,15,15,15,15,15,15,15,15,15,15,15,50,50,
68,68,15,15,15,15,15,15,15,15,15,15,15,15,68,68

1
market

6
octorok-b 2 3 8 5 8
octorok-b 1 7 8
fat_dog-o 3 11 2 12 6 14 8
