68,68,15,15,15,15,15,15,15,15,15,15,15,15,68,68,
68,68,15,15,15,15,15,15,15,15,15,15,15,15,67,68,
68,68,15,15,15,15,15,15,15,15,15,15,15,15,15,15,
68,68,15,32,15,15,32,15,15,32,15,15,32,15,15,15,
68,68,15,15,15,15,15,15,15,15,15,15,15,15,15,15,
68,68,15,32,15,15,32,15,15,32,15,15,32,15,15,15,
68,68,15,15,15,15,15,15,15,15,15,15,15,15,15,15,
68,68,15,32,15,15,32,15,15,32,15,15,32,15,15,15,
68,68,15,15,15,15,15,15,15,15,15,15,15,15,15,15,
68,68,15,15,15,15,15,15,15,15,15,15,15,15,49,50,
68,68,15,15,15,15,15,15,15,15,15,15,15,15,68,68

1
market

3
octorok-b 2 5 1 11 9
fat_dog-o 1 8 4
