68,68,15,15,15,15,15,15,15,15,15,15,15,15,68,68,
68,68,15,15,15,15,15,15,15,15,15,15,15,15,68,68,
68,68,15,15,15,15,15,15,15,15,15,15,15,15,15,15,
68,68,15,32,15,15,32,15,15,32,15,15,32,15,15,15,
68,68,15,15,15,15,15,15,15,15,15,15,15,15,15,15,
68,68,15,32,15,15,32,15,15,32,15,15,32,15,15,15,
68,68,15,15,15,15,15,15,15,15,15,15,15,15,15,15,
68,68,15,32,15,15,32,15,15,32,15,15,32,15,15,15,
68,68,51,15,15,15,15,15,15,15,15,15,15,15,15,15,
68,68,68,50,50,50,50,50,50,50,50,50,50,50,31,50,
68,68,68,68,68,68,68,68,68,68,68,68,68,68,31,68


1
market

8
fat_dog-o 1 14 7
octorok-b 3 7 6 4 3 10 9
fat_dog-o 2 13 6 12 2
fat_dog-o 2 11 7 14 3
