68,68,68,68,68,68,68,68,68,68,68,68,68,68,31,68,
68,68,68,68,68,68,68,68,68,68,68,68,68,68,31,68,
68,68,68,68,68,68,68,68,68,68,68,68,68,68,31,68,
68,68,68,68,68,68,68,68,68,68,68,68,68,68,31,68,
68,68,68,68,68,68,68,68,68,68,68,68,68,68,31,68,
68,68,15,15,15,15,15,15,15,15,15,15,15,15,15,68,
68,68,15,15,15,15,15,15,15,15,15,15,15,15,15,68,
68,68,15,15,15,15,15,15,15,15,15,15,15,15,15,68,
68,68,15,15,15,15,15,15,15,15,15,15,15,15,15,68,
68,68,15,15,15,15,15,15,15,15,15,15,15,15,68,68,
68,68,15,15,15,15,15,15,15,15,15,15,15,15,68,68

1
market

10
octorok-b 3 3 4 7 3 8 5
octorok-b 6 5 4 8 3 3 2 8 4 6 4 6 1
fat_dog-o 1 14 5
