20,20,3,3,3,3,3,3,3,3,3,3,3,3,20,20,
20,20,3,3,3,3,3,3,3,3,3,3,3,3,20,20,
20,20,3,3,3,3,3,3,3,3,3,3,3,3,20,20,
20,20,3,3,3,3,3,3,3,3,3,3,3,3,3,20,
20,20,3,3,3,3,3,3,3,3,3,3,3,3,3,3,
20,20,3,3,3,3,3,3,3,3,3,3,3,3,3,3,
20,20,3,3,3,3,3,3,3,3,3,3,3,3,3,3,
20,20,3,3,3,3,3,3,3,3,3,3,3,3,3,20,
20,20,3,3,3,3,3,3,3,3,3,3,3,3,20,20,
20,20,20,20,20,20,20,20,20,20,20,20,20,20,20,20,
20,20,20,20,20,20,20,20,20,20,20,20,20,20,20,20

1
market

4
fat_dog-o 1 6 10
octorok-b 3 5 5 5 7 3 5
