62,3,3,3,3,3,3,3,3,3,3,3,3,3,3,3,
62,3,3,3,3,3,3,3,3,3,3,3,3,3,3,3,
62,3,3,3,3,3,3,3,3,3,3,3,3,3,3,3,
62,3,3,3,3,3,3,3,3,3,3,3,3,3,3,3,
62,3,3,3,3,3,3,3,3,3,3,3,3,3,3,3,
62,3,3,3,3,3,3,3,3,3,3,3,3,3,3,3,
62,3,3,3,3,3,3,3,3,3,3,3,3,3,3,3,
62,3,3,3,3,3,3,3,3,3,3,3,3,3,3,3,
62,3,3,3,3,3,3,3,3,3,3,3,3,3,3,3,
62,45,3,3,3,3,3,3,3,3,3,3,3,3,3,3,
62,62,44,44,44,44,44,44,44,44,44,44,44,44,44,44
