56,56,56,56,56,56,56,56,56,56,56,56,56,56,56,56,
56,56,56,56,56,56,56,56,56,137,57,55,57,55,56,56,
56,56,55,56,56,56,56,56,56,3,3,3,3,3,56,56,
56,57,3,55,57,55,56,56,57,3,3,3,3,3,55,56,
56,3,3,3,3,3,3,3,3,3,3,3,3,3,3,55,
3,3,3,3,3,3,3,3,3,3,3,3,3,3,3,3,
38,3,3,3,3,3,3,3,3,3,3,3,3,3,3,37,
56,39,3,3,3,3,3,3,3,3,3,3,3,3,37,56,
56,56,3,3,3,3,3,3,3,3,3,3,3,3,56,56,
56,56,38,38,38,38,38,19,38,38,38,38,39,37,56,56,
56,56,56,56,56,56,56,19,56,56,56,56,56,56,56,56


1
market

3
fat_dog-o 1 2 5
fat_dog-o 2 5 5 5 6
