56,56,56,56,56,56,56,19,56,56,56,56,56,56,56,56,
56,56,56,56,56,56,56,19,56,56,56,56,56,56,56,56,
3,3,3,3,3,3,3,3,3,3,3,3,3,3,55,56,
6,3,3,4,6,3,3,3,3,3,3,3,2,3,3,56,
24,3,3,22,24,3,3,3,3,3,2,3,3,3,3,56,
3,3,3,3,3,3,3,3,2,3,3,3,2,3,3,56,
3,3,4,6,3,3,3,3,3,3,2,3,3,3,3,56,
3,3,22,24,3,3,3,3,3,3,3,3,2,3,3,56,
3,3,3,3,3,3,3,3,3,3,3,3,3,3,37,56,
38,38,38,38,38,38,38,38,38,38,38,38,38,38,56,56,
56,56,56,56,56,56,56,56,56,56,56,56,56,56,56,56


1
market

2
octorok-b 1 11 6
fat_dog-o 1 1 5
