56,56,56,56,56,56,56,56,56,56,56,56,56,56,56,56,
56,56,56,56,56,56,56,56,56,56,56,56,56,56,56,56,
3,3,3,3,3,3,3,3,3,3,3,3,3,3,55,56,
6,3,3,4,6,3,3,3,3,3,3,3,2,3,3,56,
24,3,3,22,24,3,3,3,3,3,2,3,3,3,3,56,
3,3,3,3,3,3,3,3,2,3,3,3,2,3,3,56,
3,3,4,6,3,3,3,3,3,3,2,3,3,3,3,56,
3,3,22,24,3,3,3,3,3,3,3,3,2,3,3,56,
3,3,3,3,3,3,3,3,3,3,3,3,3,3,37,56,
38,38,38,38,38,38,38,38,38,38,38,38,38,38,56,56,
56,56,56,56,56,56,56,56,56,56,56,56,56,56,56,56

1
market

3
fat_dog-o 2 0 3 7 7
fat_dog-o 1 13 2
