68,68,15,15,15,15,15,15,15,15,15,15,15,15,14,14,
68,69,15,15,15,15,15,15,15,15,15,15,15,15,14,14,
15,15,15,15,15,15,15,15,15,15,15,15,15,15,14,14,
15,15,15,32,15,15,32,15,15,32,15,15,32,15,14,14,
15,15,15,15,15,15,15,15,15,15,15,15,15,15,15,15,
15,15,15,32,15,15,32,15,15,32,15,15,32,15,15,15,
15,15,15,15,15,15,15,15,15,15,15,15,15,15,15,15,
15,15,15,32,15,15,32,15,15,32,15,15,32,15,14,14,
15,15,15,15,15,15,15,15,15,15,15,15,15,15,14,14,
50,51,15,15,15,15,15,15,15,15,15,15,15,15,14,14,
68,68,15,15,15,15,15,15,15,15,15,15,15,15,14,14

1
market

9
octorok-b 6 7 10 2 0 11 10 13 2 0 4 13 4
octorok-b 1 10 8
octorok-b 1 10 0
fat_dog-o 1 9 0
