20,20,20,20,20,20,20,20,20,20,20,20,20,20,20,20,
20,20,20,20,20,20,20,20,20,20,20,20,20,20,20,20,
20,20,3,3,3,3,3,3,3,3,3,3,20,20,20,20,
20,3,3,3,3,3,3,3,3,3,3,3,20,20,20,20,
20,3,3,20,3,20,3,20,3,20,3,3,3,3,3,3,
20,3,3,3,3,3,3,3,3,3,3,3,3,3,3,3,
20,3,3,20,3,20,3,20,3,20,3,3,3,3,3,3,
20,3,3,3,3,3,3,3,3,3,3,3,20,20,20,20,
20,20,3,3,3,3,3,3,3,3,3,3,20,20,20,20,
20,20,20,20,20,20,20,20,20,20,3,3,20,20,20,20,
20,20,20,20,20,20,20,20,20,20,3,3,20,20,20,20

1
market

9
octorok-b 7 7 7 13 7 13 7 12 5 3 4 16 5 10 4
fat_dog-o 1 6 3
octorok-b 1 3 4
