20,20,20,20,20,20,20,20,20,20,3,3,20,20,20,20,
20,20,20,20,20,20,20,20,20,20,3,3,20,20,20,20,
20,20,20,20,20,20,20,20,20,20,3,3,20,20,20,20,
20,20,20,20,20,20,20,20,20,20,3,3,20,20,20,20,
3,3,3,3,3,3,3,3,3,3,3,3,3,3,3,3,
3,3,3,3,3,3,3,3,3,3,3,3,3,3,3,3,
3,3,3,3,3,3,3,3,3,3,3,3,3,3,3,3,
20,20,20,20,20,20,20,20,20,20,3,3,20,20,20,20,
20,20,20,20,20,20,20,20,20,20,3,3,20,20,20,20,
20,20,20,20,20,20,20,20,20,20,3,3,20,20,20,20,
20,20,20,20,20,20,20,20,20,20,3,3,20,20,20,20

1
market

1
octorok-b 1 11 4
