56,56,56,56,56,56,56,56,56,56,3,3,56,56,56,56,
56,56,56,57,55,56,56,56,56,57,3,3,55,56,56,56,
3,3,3,3,3,3,3,3,3,3,3,3,3,55,56,56,
3,3,3,3,3,3,3,3,3,3,3,3,3,3,55,57,
3,3,3,3,3,3,3,3,3,3,3,3,3,3,3,3,
3,3,3,3,3,3,3,3,3,3,3,3,3,3,3,3,
3,3,3,3,3,3,3,3,3,3,3,3,3,3,3,3,
3,3,3,3,3,3,3,3,3,3,3,3,3,3,37,39,
3,3,3,3,3,3,3,3,3,3,3,3,3,37,56,56,
38,38,38,38,38,38,38,38,38,38,38,38,38,56,56,56,
56,56,56,56,56,56,56,56,56,56,56,56,56,56,56,56

1
market

6
octorok-b 5 11 7 10 3 11 9 16 6 1 6
fat_dog-o 1 8 9
