56,56,56,56,56,56,56,56,56,56,56,56,56,56,56,56,
56,56,56,56,56,56,56,56,56,56,56,56,56,56,56,56,
56,56,56,56,56,56,56,56,56,56,57,55,56,56,56,56,
56,56,56,56,56,56,56,56,56,56,3,3,55,56,56,56,
56,56,56,56,56,56,56,56,56,57,3,3,3,55,56,56,
3,3,3,3,3,3,3,3,3,3,3,3,3,3,3,3,
38,38,38,19,38,38,38,38,38,39,3,3,3,3,3,3,
56,56,56,19,56,56,56,56,56,56,3,3,3,3,3,3,
56,56,56,19,56,56,56,56,56,56,39,3,3,3,3,3,
56,56,56,19,56,56,56,56,56,56,56,38,38,38,38,38,
56,56,56,19,56,56,56,56,56,56,56,56,56,56,56,56
1
market

9
fat_dog-o 2 11 5 15 2
fat_dog-o 6 3 5 14 4 12 6 15 2 12 2 3 5
fat_dog-o 1 7 5
