56,56,56,19,56,56,56,56,56,56,56,56,56,56,56,56,
56,56,56,19,56,56,56,56,56,56,56,56,56,56,56,56,
56,56,56,19,56,56,56,57,3,3,3,3,3,3,3,3,
56,56,56,19,56,56,57,3,3,4,6,3,4,6,3,4,
56,56,56,19,56,57,3,3,3,22,24,3,22,24,3,22,
56,57,3,3,3,3,3,3,3,3,3,3,3,3,3,3,
56,3,3,3,3,3,3,3,3,3,4,6,3,4,6,3,
56,3,3,3,3,3,3,3,3,3,22,24,3,22,24,3,
56,39,3,3,3,3,3,3,3,3,3,3,3,3,3,3,
56,56,38,38,38,38,38,38,38,38,38,38,38,38,38,38,
56,56,56,56,56,56,56,56,56,56,56,56,56,56,56,56

1
market

3
fat_dog-o 3 7 6 11 6 3 4
