56,56,56,56,56,56,56,56,56,56,56,56,56,56,56,56,
56,56,56,56,56,56,56,56,56,56,56,56,56,56,56,56,
56,57,3,3,3,3,3,3,3,3,3,3,3,3,55,56,
56,3,3,3,3,73,74,74,74,74,75,3,3,3,3,56,
56,3,3,20,3,91,92,92,92,92,93,3,20,3,3,56,
56,3,3,3,3,91,92,92,92,92,93,3,3,3,3,56,
56,3,3,20,3,109,110,110,110,110,111,3,20,3,3,56,
56,3,3,3,3,3,3,3,3,3,3,3,3,3,3,56,
56,39,3,3,3,3,3,3,3,3,3,3,3,3,37,56,
56,56,38,38,38,38,38,3,3,38,38,38,38,38,56,56,
56,56,56,56,56,56,56,3,3,56,56,56,56,56,56,56
1
market

7
octorok-b 7 15 6 2 6 9 9 9 1 12 9 13 4 9 2
