20,20,20,20,20,20,20,3,3,20,20,20,20,20,20,20,
20,20,20,20,20,20,20,3,3,20,20,20,20,20,20,20,
20,20,3,3,3,3,3,3,3,3,3,3,3,3,3,3,
20,20,3,3,20,20,20,20,20,20,20,20,20,20,20,20,
3,3,3,3,20,20,20,20,20,20,20,20,20,20,20,20,
3,3,3,3,20,20,20,20,20,20,20,20,20,20,20,20,
3,3,3,3,20,20,20,20,20,20,20,20,20,20,20,20,
20,20,3,3,20,20,20,20,20,20,20,20,20,20,20,20,
20,20,3,3,3,3,3,3,3,3,3,3,3,3,3,3,
20,20,20,20,20,3,3,20,20,3,3,3,3,3,20,20,
20,20,20,20,20,3,3,20,20,3,3,3,3,3,20,20
1
market

10
octorok-b 8 1 7 3 8 2 7 4 6 1 5 9 3 10 1 12 9
fat_dog-o 2 11 1 13 9
