20,20,20,20,20,20,3,3,20,20,20,20,20,20,20,20,
20,20,20,20,20,20,3,3,20,20,20,20,20,20,20,20,
20,20,20,20,20,20,3,3,3,3,3,3,3,3,3,3,
20,20,20,20,20,20,20,20,20,20,20,20,20,20,20,20,
3,3,20,20,20,20,20,20,20,20,20,20,20,20,20,20,
3,3,3,3,3,3,20,20,20,20,20,20,20,20,20,20,
3,3,3,3,3,3,20,20,20,20,20,20,20,20,20,20,
20,20,3,3,3,3,20,20,20,20,20,20,20,20,20,20,
20,20,3,3,3,3,3,3,3,3,3,3,3,3,3,3,
20,20,20,20,20,20,20,20,20,20,20,20,20,20,20,20,
20,20,20,20,20,20,20,20,20,20,20,20,20,20,20,20

1
market

9
fat_dog-o 3 3 4 4 3 6 2
fat_dog-o 3 12 8 0 6 15 2
fat_dog-o 2 5 3 2 5
fat_dog-o 1 11 2
