56,56,56,56,56,56,56,56,56,56,56,56,56,56,56,56,
56,57,55,56,56,56,56,56,56,56,56,56,56,56,56,56,
56,3,3,55,56,56,56,56,56,56,56,56,56,56,56,56,
56,3,3,3,55,56,56,56,56,56,56,56,56,56,56,56,
57,3,3,3,3,55,56,56,56,56,56,56,56,56,56,56,
3,3,3,3,3,3,3,3,3,3,3,56,56,56,56,56,
3,3,3,3,3,37,38,38,38,38,19,56,56,56,56,56,
3,3,3,3,37,56,56,56,56,56,19,56,56,56,56,56,
3,3,3,37,56,56,56,56,56,56,19,56,56,56,56,56,
38,38,38,56,56,56,56,56,56,56,19,56,56,56,56,56,
56,56,56,56,56,56,56,56,56,56,19,56,56,56,56,56

1
market

4
fat_dog-o 1 2 5
octorok-b 1 1 5
octorok-b 2 2 6 3 6
