56,56,56,56,56,56,56,56,56,56,19,56,56,56,56,56,
56,56,56,56,56,56,56,56,56,56,19,56,56,56,56,56,
3,3,3,55,56,56,56,56,56,56,19,56,56,56,57,3,
6,3,3,3,55,56,56,56,56,56,19,56,56,57,3,3,
24,3,3,3,3,55,56,56,56,56,19,56,57,3,3,3,
3,3,3,3,3,3,3,3,3,3,3,3,3,3,3,3,
3,3,3,3,3,3,3,3,3,3,3,3,3,3,3,3,
3,3,3,3,3,3,3,3,3,3,3,3,3,3,3,3,
3,3,3,3,3,3,3,3,3,3,3,3,3,3,3,3,
38,38,38,38,38,38,38,38,38,38,38,38,38,38,38,38,
56,56,56,56,56,56,56,56,56,56,56,56,56,56,56,56
