56,56,56,56,56,56,56,56,56,56,56,56,56,56,56,56,
56,56,56,56,56,56,56,56,56,56,56,56,56,56,56,56,
56,57,3,3,3,3,3,55,56,56,57,3,3,3,3,3,
56,3,3,3,3,3,3,3,56,56,3,3,3,3,3,3,
56,3,3,3,2,3,3,3,56,56,3,3,3,3,3,3,
56,3,3,2,3,2,3,3,56,56,3,3,3,3,3,3,
56,3,3,3,2,3,3,3,56,56,3,3,3,3,3,3,
56,3,3,3,3,3,3,3,56,56,3,3,3,3,3,3,
56,39,3,3,3,3,3,37,56,56,39,3,3,3,3,3,
56,56,38,38,38,38,19,56,56,56,56,38,38,19,38,38,
56,56,56,56,56,56,19,56,56,56,56,56,56,19,56,56

1
market

6
fat_dog-o 6 12 8 10 3 5 8 2 6 5 6 4 3
