56,56,56,56,56,56,56,56,56,56,56,56,56,56,56,56,
56,56,56,56,56,56,56,56,56,56,56,56,56,56,56,56,
56,3,3,3,3,3,3,3,3,3,3,3,3,3,55,56,
56,3,3,3,3,79,80,80,80,80,81,3,3,3,3,56,
56,3,3,26,3,97,98,98,98,98,99,3,26,3,3,56,
56,3,3,3,3,97,98,98,98,98,99,3,3,3,3,56,
56,3,3,26,3,115,116,116,116,116,117,3,26,3,3,56,
56,3,3,3,3,3,3,3,3,3,3,3,3,3,3,56,
56,39,3,3,3,3,3,3,3,3,3,3,3,3,37,56,
56,56,38,38,38,38,38,3,3,38,38,38,38,38,56,56,
56,56,56,56,56,56,56,3,3,56,56,56,56,56,56,56

1
market

8
octorok-b 3 2 5 2 6 13 7
fat_dog-o 2 13 7 11 4
fat_dog-o 2 13 3 9 3
octorok-b 1 1 3
