20,20,20,20,20,20,20,3,3,20,20,20,20,20,20,20,
20,20,20,20,20,20,20,3,3,20,20,20,20,20,20,20,
3,3,3,3,3,3,3,3,3,3,3,3,3,3,20,20,
20,20,3,3,3,3,3,3,3,3,3,3,3,3,3,20,
20,20,3,3,3,3,26,3,3,3,3,3,3,3,3,3,
20,20,3,3,3,3,3,3,3,3,26,3,3,3,3,3,
20,20,3,3,3,3,26,3,3,3,3,3,3,3,3,3,
20,20,3,3,3,3,3,3,3,3,3,3,3,3,3,20,
3,3,3,3,3,3,3,3,3,3,3,3,3,3,20,20,
20,20,20,20,3,3,20,3,3,3,20,3,20,3,20,20,
20,20,20,20,3,3,20,3,3,3,20,3,20,3,20,20
1
market

2
fat_dog-o 2 3 3 13 2
