20,20,20,20,3,3,20,3,3,3,20,3,20,3,20,20,
20,20,20,20,3,3,20,3,3,3,20,3,20,3,20,20,
20,20,3,3,3,3,3,3,3,3,3,3,3,3,20,20,
3,3,3,20,3,3,3,3,3,3,20,3,3,3,3,20,
3,3,3,3,3,3,20,3,3,3,3,3,3,3,3,3,
3,3,3,20,3,3,3,3,3,3,20,3,20,3,3,3,
3,3,3,3,3,3,20,3,3,3,3,3,3,3,3,3,
3,3,3,20,3,3,3,3,3,3,20,3,3,3,3,20,
20,20,3,3,3,3,3,3,3,3,3,3,3,3,20,20,
20,20,20,20,20,20,20,3,3,3,20,3,20,3,20,20,
20,20,20,20,20,20,20,3,3,3,20,3,20,3,20,20
1
market

3
fat_dog-o 2 5 2 7 7
octorok-b 1 8 10
