20,20,20,20,20,20,20,3,3,3,20,3,20,3,20,20,
20,20,20,20,20,20,20,3,3,3,20,3,20,3,20,20,
3,3,3,3,3,3,3,3,3,3,3,3,3,3,20,20,
20,20,20,20,20,20,20,3,3,3,3,3,3,3,3,20,
20,20,20,20,20,20,20,3,3,3,3,3,3,3,3,3,
20,20,20,20,20,20,20,3,3,3,20,3,3,3,3,3,
20,20,20,20,20,20,20,3,3,3,3,3,3,3,3,3,
20,20,20,20,20,20,20,3,3,3,3,3,3,3,3,20,
3,3,3,3,3,3,3,3,3,3,3,3,3,3,20,20,
20,20,20,20,20,20,20,20,20,20,20,20,20,20,20,20,
20,20,20,20,20,20,20,20,20,20,20,20,20,20,20,20
1
market

2
octorok-b 2 11 8 13 7
