56,56,56,56,56,56,56,56,56,56,56,56,56,56,56,56,
56,56,56,56,56,56,56,56,56,56,56,56,137,56,56,56,
56,56,56,56,56,56,56,56,56,56,57,3,3,3,3,55,
56,56,56,56,56,56,56,56,56,57,3,3,3,3,3,3,
56,56,56,56,57,55,56,56,57,3,3,3,3,3,3,3,
56,57,3,3,3,3,55,57,3,3,3,3,3,3,3,3,
56,3,3,3,3,3,3,3,3,3,3,3,3,3,3,3,
56,3,3,3,3,3,3,3,3,3,3,3,3,3,3,3,
56,39,3,3,3,3,37,39,3,3,3,3,3,3,3,37,
56,56,38,38,38,38,56,56,38,38,38,38,38,38,38,56,
56,56,56,56,56,56,56,56,56,56,56,56,56,56,56,56
1
market

9
fat_dog-o 4 12 5 8 5 5 2 11 6
fat_dog-o 2 12 2 11 2
fat_dog-o 3 6 4 10 3 8 2
