56,56,56,56,56,56,56,56,56,56,56,56,56,56,56,56,
56,56,56,56,56,56,56,56,56,56,56,56,56,56,56,56,
56,57,3,3,3,3,3,3,3,3,3,3,3,3,56,56,
56,3,3,3,3,3,3,3,3,3,3,3,3,3,55,56,
56,3,21,3,21,3,21,3,3,3,3,3,3,3,3,56,
56,3,3,3,3,3,3,3,3,3,3,3,3,3,3,56,
56,3,21,3,21,3,21,3,3,73,74,74,74,74,74,92,
56,3,3,3,3,3,3,3,3,91,92,92,92,92,92,92,
56,39,3,3,3,3,3,3,3,91,92,92,92,92,92,92,
56,56,38,38,38,38,38,38,3,91,92,92,92,92,92,92,
56,56,56,56,56,56,56,56,3,91,92,92,92,92,92,92
1
market

3
fat_dog-o 1 8 8
fat_dog-o 1 4 4
octorok-b 1 7 3
