56,56,56,56,56,56,56,56,3,91,92,92,92,92,92,92,
56,56,56,56,137,56,56,56,3,91,92,92,92,92,92,92,
56,57,3,3,3,3,3,3,3,91,92,92,92,92,92,92,
56,3,3,3,3,3,3,3,3,91,92,92,92,92,92,92,
56,3,3,26,3,26,3,3,3,91,92,92,92,92,92,92,
56,3,3,3,3,3,3,3,3,91,92,92,92,92,92,92,
56,3,3,26,3,26,3,3,3,91,92,92,92,92,92,92,
56,3,3,3,3,3,3,3,3,91,92,92,92,92,92,92,
56,39,3,3,3,3,3,3,3,91,92,92,92,92,92,92,
56,56,38,38,38,38,38,3,3,91,92,92,92,92,92,92,
56,56,56,56,56,56,56,3,3,91,92,92,92,92,92,92
1
market

7
fat_dog-o 6 7 1 8 10 8 6 3 7 3 2 4 7
fat_dog-o 1 8 10
