56,56,56,56,56,56,56,56,3,91,92,92,92,92,92,92,
56,56,56,56,137,56,56,56,3,91,92,92,92,92,92,92,
56,57,3,3,3,3,3,3,3,91,92,92,92,92,92,92,
56,3,3,3,3,3,3,3,3,91,92,92,92,92,92,92,
56,3,3,26,3,26,3,3,3,91,92,92,92,92,92,92,
56,3,3,3,3,3,3,3,3,91,92,92,92,92,92,92,
56,3,3,26,3,26,3,3,3,91,92,92,92,92,92,92,
56,3,3,3,3,3,3,3,3,91,92,92,92,92,92,92,
56,39,3,3,3,3,3,3,3,91,92,92,92,92,92,92,
56,56,38,38,38,38,38,3,3,91,92,92,92,92,92,92,
56,56,56,56,56,56,56,3,3,91,92,92,92,92,92,92
1
market

6
octorok-b 3 8 5 3 8 8 1
fat_dog-o 2 7 4 5 4
fat_dog-o 1 8 5
