26,26,26,26,26,26,26,3,3,91,92,92,92,92,92,92,
26,26,26,26,26,26,26,3,3,91,92,92,92,92,92,92,
26,26,3,3,3,3,3,3,3,91,92,92,92,92,92,92,
26,26,3,3,3,26,3,3,3,91,92,92,92,92,92,92,
3,3,3,3,3,3,3,3,3,109,110,110,110,110,110,110,
3,3,3,3,3,26,3,3,3,3,3,3,3,3,3,3,
3,3,3,3,3,3,3,3,3,3,3,3,3,3,44,44,
26,26,3,3,3,26,3,3,3,3,3,3,3,3,62,62,
26,26,3,3,3,3,3,3,3,3,3,3,3,3,62,62,
26,26,26,3,3,26,26,26,26,3,3,26,26,3,62,62,
26,26,26,3,3,26,26,26,26,3,3,26,26,3,62,62
1
market

6
fat_dog-o 2 4 2 5 1
octorok-b 4 4 8 13 5 5 3 10 1
