62,62,62,3,3,62,62,62,62,62,3,62,62,3,62,62,
62,62,62,3,3,61,62,62,137,63,3,61,63,3,61,62,
62,62,63,3,3,3,3,3,3,3,3,3,3,3,3,3,
61,63,3,3,3,3,3,3,3,3,3,3,3,3,3,3,
3,3,3,3,3,3,26,3,3,3,3,3,3,3,3,3,
3,3,3,3,3,3,3,3,3,3,3,3,3,3,3,3,
3,3,3,3,3,3,26,3,3,3,3,3,3,3,3,3,
43,45,3,3,3,3,3,3,3,3,3,3,3,3,3,3,
62,62,45,3,3,3,3,3,3,3,3,3,3,3,3,3,
62,62,62,44,44,44,44,44,44,44,44,44,44,44,44,44,
62,62,62,62,62,62,62,62,62,62,62,62,62,62,62,62
1
market

3
fat_dog-o 2 13 4 14 5
octorok-b 1 9 6
