62,62,62,62,62,62,62,62,62,62,62,62,62,62,62,62,
62,62,62,62,62,62,62,62,62,62,62,62,62,62,62,62,
62,63,3,3,3,3,3,3,3,3,3,3,3,3,61,62,
63,3,3,3,3,3,3,40,41,42,3,3,3,3,3,62,
3,3,3,3,21,3,21,58,137,60,21,3,21,3,3,62,
3,3,3,3,3,3,3,3,3,3,3,3,3,3,3,62,
3,3,3,3,21,3,21,3,3,3,21,3,21,3,3,62,
45,3,3,3,3,3,3,3,3,3,3,3,3,3,3,62,
62,45,3,3,3,3,3,3,3,3,3,3,3,3,43,62,
62,62,44,44,44,44,44,44,44,44,44,44,44,44,62,62,
62,62,62,62,62,62,62,62,62,62,62,62,62,62,62,62
1
market

4
octorok-b 1 13 8
octorok-b 1 8 8
octorok-b 1 12 8
octorok-b 1 3 2
