56,56,56,56,56,56,56,56,56,56,56,56,56,56,56,56,
56,56,56,56,56,56,56,56,56,56,56,56,56,56,56,56,
57,55,57,3,3,3,3,3,3,3,3,3,3,3,55,56,
3,3,3,3,37,39,3,3,3,3,37,39,3,3,3,56,
3,3,3,37,56,56,39,3,3,37,56,56,39,3,3,55,
3,3,3,56,56,56,56,3,3,56,56,56,56,3,3,3,
3,3,3,55,56,56,57,3,3,55,56,56,57,3,3,37,
3,3,3,3,3,3,3,3,3,3,3,3,3,3,3,56,
39,37,39,3,3,3,3,3,3,3,3,3,3,3,37,56,
56,56,56,38,38,38,38,38,38,38,38,38,38,38,56,56,
56,56,56,56,56,56,56,56,56,56,56,56,56,56,56,56

1
market

5
octorok-b 1 8 4
octorok-b 3 15 4 13 4 12 4
fat_dog-o 1 10 3
