56,56,56,56,19,56,56,56,56,56,56,56,56,56,56,56,
56,56,56,56,19,56,56,56,56,56,56,56,56,56,56,56,
56,56,56,56,19,56,56,56,56,56,56,56,56,56,56,56,
56,56,56,56,19,56,57,55,56,56,56,57,55,56,56,57,
56,56,56,56,3,3,3,3,3,3,3,3,3,3,3,3,
56,56,56,56,3,3,3,3,3,3,3,3,3,3,3,3,
92,92,92,92,74,74,74,74,74,74,74,74,74,74,74,74,
92,92,92,92,92,92,92,92,92,92,92,92,92,92,92,92,
92,92,92,92,92,92,92,92,92,92,92,92,92,92,92,92,
92,92,92,92,92,92,92,92,92,92,92,92,92,92,92,92,
92,92,92,92,92,92,92,92,92,92,92,92,92,92,92,92

1
market

8
octorok-b 5 12 6 10 6 13 7 14 7 10 7
octorok-b 2 13 7 10 6
octorok-b 1 10 7
