92,56,56,56,56,56,56,56,56,56,56,56,56,56,56,92,
92,56,56,56,56,56,56,56,56,56,56,56,56,56,56,92,
92,56,3,3,3,3,3,3,3,3,3,3,3,3,56,92,
92,56,3,3,46,48,3,46,47,48,3,46,48,3,56,92,
92,56,3,3,64,66,3,64,137,66,3,64,66,3,56,92,
92,56,3,3,3,3,3,3,3,3,3,3,3,3,56,92,
92,56,3,3,3,3,3,3,3,3,3,3,3,3,56,92,
92,56,3,3,3,3,3,3,3,3,3,3,3,3,56,92,
92,56,3,3,3,3,3,3,3,3,3,3,3,3,56,92,
92,56,38,38,38,38,38,38,19,38,38,38,38,38,56,92,
92,56,56,56,56,56,56,56,19,56,56,56,56,56,56,92

1
market

10
fat_dog-o 8 13 2 12 4 7 4 3 4 10 7 5 4 11 4 2 3
fat_dog-o 1 5 8
fat_dog-o 1 13 8
