92,92,92,92,92,92,92,92,92,92,92,92,92,92,92,92,
92,92,92,92,92,92,92,92,92,92,92,92,92,92,92,92,
92,92,92,92,92,92,92,92,92,92,92,92,92,92,92,92,
92,92,92,92,92,92,92,92,92,92,92,92,92,92,92,92,
110,110,110,110,92,92,92,92,138,110,110,110,110,110,110,110,
3,3,3,3,128,92,92,127,3,3,3,3,3,3,3,3,
44,44,3,3,3,91,93,3,3,3,3,3,3,3,44,44,
62,62,3,3,3,91,93,3,3,3,3,3,3,3,62,62,
62,62,3,3,3,91,93,3,3,3,3,3,3,3,62,62,
62,62,3,3,3,91,93,3,3,3,44,3,44,3,62,62,
62,62,3,3,3,91,93,3,3,3,62,3,62,3,62,62

1
market

3
fat_dog-o 1 12 2
fat_dog-o 2 3 5 12 6
