62,62,3,3,3,91,93,3,3,3,62,3,62,3,62,62,
62,63,3,3,3,91,93,3,3,3,62,3,62,3,61,62,
3,3,3,3,3,91,93,3,3,3,3,3,3,3,3,3,
3,3,3,3,3,91,93,3,3,3,2,3,3,3,3,3,
3,3,3,3,3,91,93,3,3,3,3,3,2,3,3,3,
3,3,3,3,3,132,132,3,3,3,2,3,3,3,3,3,
3,3,3,3,3,91,93,3,3,3,3,3,2,3,3,3,
3,3,3,3,3,91,93,3,3,3,2,3,3,3,3,3,
3,3,3,3,3,91,93,3,3,3,3,3,3,3,3,3,
44,44,44,45,3,91,93,44,44,44,44,44,44,44,44,44,
62,62,62,62,3,91,93,62,62,62,62,62,62,62,62,62


1
market

1
fat_dog-o 1 9 8
