62,62,62,62,3,91,93,62,62,62,62,62,62,62,62,62,
62,62,137,63,3,91,93,61,62,62,62,62,62,62,62,62,
62,63,3,3,3,91,93,3,3,3,3,3,3,3,3,3,
62,3,3,3,3,91,93,3,8,3,3,3,8,3,3,3,
62,3,3,3,3,91,93,3,3,3,8,3,3,3,3,3,
62,3,3,8,3,91,93,3,8,3,3,3,8,3,3,3,
62,3,3,3,3,91,93,3,3,3,8,3,3,3,3,3,
62,3,3,3,3,91,93,3,8,3,3,3,8,3,3,3,
62,45,3,3,3,91,93,3,3,3,3,3,3,3,3,3,
62,62,44,44,45,91,93,3,3,3,3,3,3,3,3,3,
62,62,62,62,62,91,93,62,62,62,62,62,62,62,62,62

1
market

5
octorok-b 2 3 7 8 3
octorok-b 3 9 2 4 8 4 7
