56,56,56,56,56,56,56,56,56,56,56,56,56,56,56,56,
56,56,56,56,56,56,56,57,55,56,56,56,56,56,56,56,
56,56,56,56,57,55,57,3,3,55,56,56,56,56,56,56,
56,56,56,57,3,3,3,3,3,3,56,56,56,56,56,56,
57,55,57,3,3,3,3,3,3,3,55,57,55,57,55,57,
3,3,3,3,3,3,3,3,3,3,3,3,3,3,3,3,
39,37,39,3,3,3,3,3,3,3,37,39,37,39,37,39,
56,56,56,39,3,3,3,3,3,3,56,56,56,56,56,56,
56,56,56,56,39,37,39,3,3,37,56,56,56,56,56,56,
56,56,56,56,56,56,56,39,37,56,56,56,56,56,56,56,
56,56,56,56,56,56,56,56,56,56,56,56,56,56,56,56

1
market

3
fat_dog-o 1 11 6
fat_dog-o 2 10 6 4 5
