56,56,56,56,56,56,56,56,56,56,56,56,56,56,56,56,
56,56,57,55,56,56,137,56,56,56,56,56,56,56,56,56,
55,57,3,3,55,57,3,3,56,56,56,56,56,56,57,3,
3,3,3,3,3,3,3,3,56,56,56,56,56,57,3,3,
3,3,3,3,3,3,3,3,55,56,57,55,57,3,3,3,
3,3,3,3,3,3,3,3,3,3,3,3,3,3,3,3,
3,3,3,3,3,3,3,3,3,3,3,37,39,3,3,3,
3,3,3,3,3,3,3,3,3,3,3,56,56,39,3,3,
37,39,3,3,37,39,3,3,3,3,3,56,56,56,39,3,
56,56,39,37,56,56,38,38,38,38,38,56,56,56,56,38,
56,56,56,56,56,56,56,56,56,56,56,56,56,56,56,56


1
market

9
fat_dog-o 7 3 7 3 7 1 3 14 5 15 3 4 5 3 5
fat_dog-o 2 4 6 10 3
