56,56,56,56,56,56,56,56,56,56,56,56,56,56,56,56,
56,56,56,137,56,56,56,56,56,56,56,56,56,56,56,56,
56,57,3,3,3,55,56,56,57,3,56,56,56,56,56,56,
56,3,3,3,3,3,55,57,3,3,55,56,57,55,56,57,
56,3,3,3,3,3,3,3,3,3,3,3,3,3,3,3,
56,3,3,3,3,3,3,3,3,3,3,3,3,3,3,3,
56,3,3,3,3,3,3,3,3,73,74,74,74,74,74,74,
56,3,3,3,3,3,37,39,3,91,92,92,92,92,92,92,
56,39,3,3,3,37,56,56,39,91,92,92,92,92,92,92,
56,56,3,3,37,56,56,56,56,91,92,92,92,92,92,92,
56,56,3,3,56,56,56,56,56,91,92,92,92,92,92,92


1
market

1
fat_dog-o 1 13 5
