92,92,92,92,92,92,92,92,92,92,92,92,92,92,92,92,
92,92,92,92,92,92,92,92,92,92,92,92,92,92,92,92,
92,92,92,92,92,92,92,92,92,92,92,92,92,92,92,92,
92,92,92,92,92,92,92,92,92,92,92,92,92,92,92,92,
92,92,92,92,92,92,92,92,110,110,110,110,110,110,110,110,
92,92,92,92,92,92,92,127,3,3,3,3,3,3,3,3,
92,92,92,92,92,92,93,3,3,3,3,3,3,3,3,3,
92,92,92,92,92,92,93,3,3,26,26,26,26,26,26,26,
92,92,92,92,92,92,93,3,3,26,26,26,26,26,26,26,
92,92,92,92,92,92,93,3,3,26,26,26,26,26,26,26,
92,92,92,92,92,92,93,3,3,26,26,26,26,26,26,26


1
market

4
fat_dog-o 1 13 4
octorok-b 2 9 4 6 4
octorok-b 1 8 1
