92,92,92,92,92,92,93,3,3,26,26,26,26,26,26,26,
92,92,92,92,92,92,93,3,3,26,26,26,26,26,26,26,
92,92,92,92,92,92,93,3,3,3,3,3,3,3,3,3,
92,92,92,92,92,92,93,3,3,3,3,3,3,3,3,3,
110,110,110,110,110,110,111,3,3,3,26,3,26,26,3,3,
3,3,3,3,3,3,3,3,3,3,3,3,3,3,3,3,
44,44,44,3,3,3,3,3,3,3,26,3,26,26,3,3,
62,62,62,3,3,3,3,3,3,3,3,3,3,3,3,3,
62,62,62,3,3,3,3,3,3,3,3,3,3,3,3,3,
62,62,62,26,26,26,26,26,26,26,26,26,26,26,26,26,
62,62,62,26,26,26,26,26,26,26,26,26,26,26,26,26

1
market

6
octorok-b 6 8 3 7 4 11 3 4 3 8 3 14 8
