62,62,62,62,62,62,62,62,62,62,62,62,62,62,62,62,
62,62,62,62,62,62,62,137,62,62,62,62,62,62,62,62,
3,3,3,3,3,3,3,3,3,3,3,3,3,3,61,62,
3,3,3,2,2,2,2,3,3,3,3,3,3,3,3,61,
3,3,3,3,3,3,3,3,2,2,2,3,3,3,3,3,
3,3,3,2,2,2,2,3,3,3,3,3,3,3,3,3,
3,3,3,3,3,3,3,3,2,2,2,3,3,3,3,3,
3,3,3,2,2,2,2,3,3,3,3,3,3,3,3,43,
3,3,3,3,3,3,3,3,3,3,3,3,3,3,43,62,
44,44,44,44,44,44,44,44,44,44,44,45,3,3,62,62,
62,62,62,62,62,62,62,62,62,62,62,62,3,3,62,62

1
market

10
octorok-b 6 3 8 9 8 8 9 6 5 2 9 15 5
octorok-b 1 13 5
fat_dog-o 3 1 8 11 8 12 8
