62,62,62,62,62,62,62,62,62,62,62,62,62,62,62,62,
62,62,62,62,62,62,23,62,62,62,62,63,3,61,62,62,
3,3,3,3,3,3,3,3,3,3,3,3,3,3,62,62,
3,3,3,3,3,3,20,20,20,3,20,3,3,3,61,62,
3,3,3,3,3,3,3,3,20,3,20,3,3,3,3,61,
3,3,3,3,3,3,20,20,20,20,20,3,3,3,3,3,
3,3,3,3,3,3,20,3,20,3,3,3,3,3,3,43,
3,3,3,3,3,3,20,3,20,20,20,3,3,3,43,62,
3,3,3,3,3,3,3,3,3,3,3,3,3,3,62,62,
44,44,44,44,44,44,44,44,44,44,44,44,44,44,62,62,
62,62,62,62,62,62,62,62,62,62,62,62,62,62,62,62

