56,56,56,56,56,56,56,56,56,56,56,56,56,56,56,56,
56,56,56,56,56,56,56,56,56,56,56,56,56,56,56,56,
56,56,56,56,56,56,56,56,56,56,56,56,56,56,56,56,
56,56,56,56,56,56,56,57,55,56,56,56,56,56,56,56,
56,56,56,56,56,56,57,3,3,55,23,56,57,55,56,56,
3,3,3,3,3,3,3,3,3,3,3,3,3,3,3,3,
38,38,38,38,19,38,39,3,3,37,38,38,39,37,38,38,
56,56,56,56,19,56,56,39,37,56,56,56,56,56,56,56,
56,56,56,56,19,56,56,56,56,56,56,56,56,56,56,56,
56,56,56,56,19,56,56,56,56,56,56,56,56,56,56,56,
56,56,56,56,19,56,56,56,56,56,56,56,56,56,56,56
1
market

6
fat_dog-o 6 15 6 1 6 8 7 13 6 3 6 8 5
