56,56,56,56,56,56,56,56,56,56,56,56,56,56,56,56,
56,56,56,56,56,56,56,56,56,56,56,56,56,56,56,56,
56,56,56,56,56,56,56,56,56,56,56,56,56,56,56,56,
56,56,56,56,56,56,56,57,55,56,56,56,56,56,56,56,
56,56,56,56,56,56,57,3,3,55,137,56,57,55,56,56,
3,3,3,3,3,3,3,3,3,3,3,3,3,3,3,3,
38,38,38,38,19,38,39,3,3,37,38,38,39,37,38,38,
56,56,56,56,19,56,56,39,37,56,56,56,56,56,56,56,
56,56,56,56,19,56,56,56,56,56,56,56,56,56,56,56,
56,56,56,56,19,56,56,56,56,56,56,56,56,56,56,56,
56,56,56,56,19,56,56,56,56,56,56,56,56,56,56,56

1
market

8
fat_dog-o 1 1 5
fat_dog-o 6 1 5 0 5 12 5 14 5 5 5 14 5
octorok-b 1 8 5
