56,56,56,56,56,56,92,3,3,3,3,56,56,56,56,56,
56,56,56,56,56,56,92,3,3,3,3,56,56,56,137,56,
56,56,56,56,56,56,92,3,3,3,3,56,56,56,3,3,
55,56,57,55,56,57,92,3,3,3,3,55,56,57,3,3,
3,3,3,3,3,3,92,3,3,3,3,3,3,3,3,3,
3,3,3,3,3,130,92,129,3,3,3,3,3,3,3,3,
74,74,74,74,74,92,92,92,74,74,74,74,74,74,74,74,
92,92,92,92,92,92,92,92,92,92,92,92,92,92,92,92,
92,92,92,92,92,92,92,92,92,92,92,92,92,92,92,92,
92,92,92,92,92,92,92,92,92,92,92,92,92,92,92,92,
92,92,92,92,92,92,92,92,92,92,92,92,92,92,92,92

1
market

3
fat_dog-o 1 12 5
fat_dog-o 1 7 7
octorok-b 1 9 9
