92,56,56,56,56,56,56,56,56,56,56,56,56,56,56,92,
92,56,56,56,56,56,56,56,56,56,56,56,56,56,56,92,
92,56,3,3,3,3,3,3,3,3,3,3,3,3,56,92,
92,56,3,4,6,3,4,5,6,3,4,6,3,3,56,92,
92,56,3,22,24,3,22,23,24,3,22,24,3,3,56,92,
92,56,3,3,3,3,3,3,3,3,3,3,3,3,3,132,
92,56,3,3,4,6,3,3,3,4,6,3,3,3,38,92,
92,56,3,3,22,24,3,3,3,22,24,3,3,3,56,92,
92,56,3,3,3,3,3,3,3,3,3,3,3,3,56,92,
92,56,38,38,38,38,38,38,38,38,38,38,38,38,56,92,
92,56,56,56,56,56,56,56,56,56,56,56,56,56,56,92
1
market

6
octorok-b 5 9 4 4 6 8 5 14 8 12 6
fat_dog-o 1 9 9
