98,98,98,98,98,98,98,98,98,98,98,98,98,98,98,98,
98,98,98,98,98,98,98,98,98,98,98,98,98,98,98,98,
98,98,98,98,98,98,98,98,98,98,98,98,98,98,98,98,
98,98,98,98,98,98,98,98,98,98,98,98,98,98,98,98,
116,116,116,116,116,116,116,116,116,116,116,116,116,116,116,116,
9,9,9,9,9,9,9,9,9,9,9,9,9,9,9,9,
3,3,3,3,3,3,3,3,3,3,3,3,3,3,3,3,
26,26,26,26,26,26,26,26,26,26,26,26,26,26,26,26,
26,26,26,26,26,26,26,26,26,26,26,26,26,26,26,26,
26,26,26,26,26,26,26,26,26,26,26,26,26,26,26,26,
26,26,26,26,26,26,26,26,26,26,26,26,26,26,26,26
1
market

8
octorok-b 4 3 5 3 6 10 5 10 6
fat_dog-o 4 14 5 4 6 8 6 15 5
