26,26,26,26,26,26,26,26,26,26,26,26,26,26,26,26,
26,26,26,26,26,26,26,26,26,26,26,26,26,26,26,26,
9,9,9,9,9,9,9,9,9,9,9,9,9,9,9,9,
9,9,9,9,9,9,9,26,9,26,9,9,9,26,9,26,
9,9,9,9,9,9,9,9,9,9,9,9,9,9,9,9,
9,9,9,26,9,26,9,26,9,26,9,26,9,26,9,26,
3,9,3,3,3,3,3,3,3,3,3,3,3,3,3,3,
9,9,9,9,9,9,9,26,9,26,9,9,9,26,9,26,
9,9,9,9,9,9,9,9,9,9,9,9,9,9,9,9,
26,26,26,26,26,26,26,26,26,26,26,26,26,26,26,26,
26,26,26,26,26,26,26,26,26,26,26,26,26,26,26,26
