62,62,62,62,62,62,62,62,62,62,62,62,62,62,62,62,
62,62,62,62,62,62,62,23,62,62,62,62,62,62,62,62,
62,63,3,3,3,3,3,3,3,61,63,3,9,9,61,62,
63,3,3,8,3,8,3,3,3,9,9,9,8,9,3,61,
3,3,3,3,3,3,3,3,3,9,3,9,9,9,9,3,
3,3,3,8,3,8,3,3,3,3,9,3,8,3,3,3,
3,3,3,3,3,3,3,3,3,3,3,3,3,3,3,3,
45,3,3,8,3,8,3,3,3,3,3,3,8,3,3,43,
62,45,3,3,3,3,3,3,3,43,45,3,3,3,43,62,
62,62,44,44,44,44,44,3,3,62,62,44,44,44,62,62,
62,62,62,62,62,62,62,3,3,62,62,62,62,62,62,62

