62,62,62,62,62,62,62,62,62,62,62,62,62,62,62,62,
62,62,62,62,62,62,62,137,62,62,62,62,62,62,62,62,
62,63,9,9,9,9,9,9,9,61,63,9,9,9,61,62,
63,9,9,8,9,8,9,9,9,9,9,9,8,9,9,61,
9,9,9,9,9,9,9,9,9,9,9,9,9,9,9,9,
9,9,9,8,9,8,9,9,9,9,9,9,8,9,9,9,
3,9,3,3,3,3,3,9,3,9,3,3,3,3,3,3,
45,9,9,8,9,8,9,9,9,9,9,9,8,9,9,43,
62,45,9,9,9,9,9,9,9,43,45,9,9,9,43,62,
62,62,44,44,44,44,44,9,9,62,62,44,44,44,62,62,
62,62,62,62,62,62,62,9,9,62,62,62,62,62,62,62

1
dungeon

10
octorok-b 6 1 5 13 2 2 6 15 4 14 5 7 3
octorok-b 2 2 6 14 7
fat_dog-o 1 3 4
fat_dog-o 1 6 6
