62,62,62,62,62,62,62,62,62,62,62,62,62,62,62,62,
62,62,62,62,62,62,62,137,62,62,62,62,62,62,62,62,
62,63,9,9,9,9,9,9,9,61,63,9,9,9,61,62,
63,9,9,8,9,8,9,9,9,9,9,9,8,9,9,61,
9,9,9,9,9,9,9,9,9,9,9,9,9,9,9,9,
9,9,9,8,9,8,9,9,9,9,9,9,8,9,9,9,
3,9,3,3,3,3,3,9,3,9,3,3,3,3,3,3,
45,9,9,8,9,8,9,9,9,9,9,9,8,9,9,43,
62,45,9,9,9,9,9,9,9,43,45,9,9,9,43,62,
62,62,44,44,44,44,44,9,9,62,62,44,44,44,62,62,
62,62,62,62,62,62,62,9,9,62,62,62,62,62,62,62

2
locked triforce
