62,62,62,62,62,62,62,3,3,62,62,62,62,62,62,62,
62,62,62,62,23,62,63,3,3,62,62,62,62,62,62,62,
62,62,62,63,3,3,3,3,3,62,62,62,62,62,62,62,
62,62,63,3,3,3,3,3,3,62,62,62,62,62,62,62,
62,63,3,3,3,3,3,3,3,61,62,62,62,62,62,62,
3,3,3,3,3,3,3,3,3,3,3,3,3,3,3,3,
44,45,3,3,3,3,3,3,3,3,3,3,3,3,44,44,
62,62,3,3,3,3,3,3,3,3,3,3,3,3,62,62,
62,62,3,3,3,3,3,3,3,3,3,3,3,3,62,62,
62,62,44,44,44,44,44,44,44,44,44,44,44,44,62,62,
62,62,62,62,62,62,62,62,62,62,62,62,62,62,62,62

2
locked triforce
