56,56,56,56,56,56,56,56,56,56,56,56,56,56,56,56,
56,56,56,56,56,56,56,57,55,56,56,56,56,56,56,56,
56,56,56,56,57,55,57,3,3,55,56,56,56,56,56,56,
56,56,56,57,3,3,3,3,3,3,56,56,56,56,56,56,
57,55,57,3,3,3,3,3,3,3,55,57,55,57,55,56,
3,3,3,3,3,3,3,3,3,3,3,3,3,3,3,3,
39,37,39,3,3,3,3,3,3,3,37,39,37,39,37,38,
56,56,56,39,3,3,3,3,3,3,56,56,56,56,56,56,
56,56,56,56,39,37,39,3,3,37,56,56,56,56,56,56,
56,56,56,56,56,56,56,39,37,56,56,56,56,56,56,56,
56,56,56,56,56,56,56,56,56,56,56,56,56,56,56,56
1
market

5
fat_dog-o 2 15 5 4 4
octorok-b 3 9 4 8 4 9 5
