20,20,20,20,20,20,20,20,20,20,20,20,20,20,20,20,
20,20,20,20,20,20,20,20,20,20,20,20,20,20,20,20,
3,3,3,3,3,3,3,3,3,3,3,3,3,3,20,3,
3,3,3,3,3,3,3,3,3,3,3,20,3,3,3,3,
3,3,3,3,3,3,3,3,3,3,3,3,3,20,3,3,
3,3,3,3,3,3,3,3,3,3,3,20,3,3,3,3,
74,74,74,74,74,74,75,3,3,3,3,3,3,20,3,3,
92,92,92,92,92,92,93,3,3,3,3,20,3,3,3,3,
92,92,92,92,92,92,93,3,3,3,3,3,3,3,20,3,
92,92,92,92,92,92,93,3,3,20,20,20,20,20,20,20,
92,92,92,92,92,92,93,3,3,20,20,20,20,20,20,20
1
market

1
octorok-b 1 7 6
