92,92,92,92,92,92,93,3,3,20,20,20,20,20,20,20,
92,92,92,92,92,92,93,3,3,20,20,20,20,20,20,20,
92,92,92,92,92,92,93,3,3,3,20,3,3,3,3,20,
92,92,92,92,92,92,93,3,3,3,3,3,3,3,3,20,
92,92,92,92,92,92,93,3,3,3,3,3,20,3,3,20,
132,132,132,132,132,132,132,3,3,3,3,3,3,3,3,20,
92,92,92,92,92,92,93,3,3,3,3,3,20,3,3,20,
92,92,92,92,92,92,93,3,3,3,3,3,3,3,3,20,
92,92,92,92,92,92,93,3,3,3,20,3,3,3,3,20,
92,92,92,92,92,92,93,3,3,20,20,20,20,20,20,20,
92,92,92,92,92,92,93,3,3,20,20,20,20,20,20,20

1
market

2
octorok-b 2 7 7 14 4
