26,26,26,26,26,26,26,3,3,26,26,26,26,26,26,26,
26,26,26,26,26,26,26,3,3,26,26,26,26,26,26,26,
3,3,3,3,3,3,3,3,3,3,3,3,3,3,3,26,
26,3,26,3,3,3,26,3,3,26,3,26,3,3,3,26,
9,3,3,3,3,3,3,3,3,3,3,3,3,3,3,3,
26,3,26,3,26,3,26,3,3,26,3,26,3,26,3,3,
3,3,3,3,3,3,3,3,3,3,3,3,3,3,3,3,
26,3,26,3,3,3,26,3,3,26,3,26,3,3,3,26,
3,3,3,3,3,3,3,3,3,3,3,3,3,3,3,26,
26,26,26,3,26,3,26,3,3,26,3,26,3,26,3,26,
26,26,26,3,26,3,26,3,3,26,3,26,3,26,3,26
1
market

8
fat_dog-o 5 15 9 6 8 16 6 11 4 14 8
octorok-b 2 5 4 11 7
octorok-b 1 4 9
