62,62,26,3,26,3,26,3,3,26,3,26,3,26,3,26,
62,62,26,3,26,3,26,3,3,26,3,26,3,26,3,26,
62,62,3,3,3,3,3,3,3,3,3,3,3,3,3,3,
62,63,3,3,3,3,26,3,3,26,3,26,3,26,3,3,
63,3,26,3,26,3,3,3,3,3,3,3,3,3,3,3,
3,3,3,3,3,3,26,3,3,26,3,26,3,26,3,3,
45,3,26,3,26,3,3,3,3,3,3,3,3,3,3,3,
62,45,3,3,3,3,26,3,3,26,3,26,3,26,3,3,
62,62,3,3,3,3,3,3,3,3,3,3,3,3,3,3,
62,62,26,26,26,26,26,26,26,26,26,26,26,26,26,26,
62,62,26,26,26,26,26,26,26,26,26,26,26,26,26,26

1
market

5
octorok-b 3 11 6 10 3 11 2
octorok-b 1 2 7
fat_dog-o 1 8 6
