26,26,26,26,26,26,26,3,3,26,26,26,26,26,26,26,
26,26,26,26,26,26,26,3,3,26,26,26,26,26,26,26,
26,26,26,26,26,26,26,3,3,26,26,26,26,26,26,26,
26,26,26,26,26,26,26,3,3,26,26,26,26,26,26,26,
3,3,3,3,3,3,3,3,3,3,3,3,3,3,3,3,
3,3,3,3,3,3,3,3,3,3,3,3,3,3,3,3,
3,3,3,3,3,3,3,3,3,79,80,80,80,80,80,80,
26,26,26,26,26,26,26,3,3,97,98,98,98,98,98,98,
26,26,26,26,26,26,26,3,3,97,98,98,98,98,98,98,
26,26,26,26,26,26,26,3,3,97,98,98,98,98,98,98,
26,26,26,26,26,26,26,3,3,97,98,98,98,98,98,98

1
market

1
octorok-b 1 8 6
