26,26,26,26,26,26,26,3,3,97,98,98,98,98,98,98,
26,26,26,26,26,26,26,3,3,97,98,98,98,98,98,98,
26,26,3,3,3,3,3,3,3,97,98,98,98,98,98,98,
26,3,3,3,26,3,3,3,3,97,98,98,98,98,98,98,
3,3,26,3,3,3,3,3,3,115,116,116,116,116,116,116,
3,3,3,3,26,3,3,3,3,3,3,3,3,3,3,3,
3,3,26,3,3,3,3,3,3,3,3,3,3,3,3,3,
26,3,3,3,26,3,3,3,3,3,3,3,3,3,3,3,
26,26,3,3,3,3,3,3,3,3,3,3,3,3,3,3,
26,26,26,26,26,26,26,26,26,26,26,26,26,26,26,26,
26,26,26,26,26,26,26,26,26,26,26,26,26,26,26,26

1
market

7
fat_dog-o 4 3 6 6 8 10 4 8 5
octorok-b 3 4 7 10 5 5 3
