56,56,56,56,56,56,56,56,56,56,56,56,56,56,56,56,
56,56,23,56,56,56,56,56,56,56,56,56,56,56,56,56,
56,57,3,3,3,3,3,3,3,3,3,3,3,3,55,56,
56,3,3,73,74,74,74,74,74,74,74,75,3,3,3,56,
56,3,3,91,92,92,92,92,92,92,92,93,3,3,3,56,
56,3,3,91,92,92,92,92,92,92,92,93,3,3,3,56,
56,3,3,109,110,92,92,92,110,110,110,111,3,3,3,56,
56,3,3,3,3,128,92,127,3,3,3,3,3,3,3,56,
56,39,3,3,3,3,92,3,3,3,3,3,3,3,37,56,
56,56,38,38,38,38,92,38,38,38,38,38,38,19,56,56,
56,56,56,56,56,56,92,56,56,56,56,56,56,19,56,56


1
market

7
octorok-b 7 2 2 8 3 11 2 14 6 3 2 8 8 1 5
