56,56,56,56,56,56,131,56,56,56,56,56,56,19,56,56,
56,56,56,56,56,56,131,56,56,56,56,56,56,19,56,56,
56,56,56,56,56,56,131,56,56,56,56,56,56,19,56,56,
56,56,56,56,56,56,131,56,56,56,56,56,56,19,56,56,
110,110,110,110,110,110,131,56,56,56,56,56,56,19,56,56,
3,3,3,3,3,3,3,3,3,3,3,3,3,3,3,3,
3,3,3,3,3,3,3,3,3,3,3,3,3,3,3,38,
38,38,38,38,38,38,38,3,3,3,3,3,3,3,3,56,
56,56,56,56,56,56,56,3,3,3,3,3,3,3,3,56,
56,56,56,56,56,56,56,38,38,38,38,38,38,38,38,56,
56,56,56,56,56,56,56,56,56,56,56,56,56,56,56,56

1
market

1
fat_dog-o 1 13 3
