56,56,56,56,56,56,56,56,56,56,56,56,56,56,56,56,
56,56,56,56,56,56,56,56,56,56,56,56,56,56,56,56,
59,59,59,59,59,59,59,59,59,59,59,59,59,59,59,59,
59,59,59,59,59,59,59,59,59,59,59,59,59,59,59,59,
59,59,59,59,59,59,59,59,59,59,59,59,59,59,59,59,
59,59,59,59,59,59,59,59,59,59,59,59,59,59,59,59,
59,59,59,59,59,59,59,59,59,59,59,59,59,59,59,59,
59,59,59,59,59,59,59,59,59,59,59,59,59,59,59,59,
59,59,59,59,59,59,59,59,59,59,59,59,59,59,59,59,
38,38,59,59,59,59,59,59,59,59,59,59,59,59,59,38,
56,56,59,59,59,59,59,59,59,59,59,59,59,59,59,56

1
market

10
octorok-b 3 1 5 9 9 4 3
fat_dog-o 4 4 7 3 3 3 5 6 3
fat_dog-o 1 4 9
fat_dog-o 1 5 1
octorok-b 1 12 4
