56,56,59,59,59,59,59,59,59,59,59,59,59,59,59,56,
56,56,59,59,59,59,59,59,59,59,59,59,59,59,59,56,
56,56,59,59,59,59,59,59,59,59,59,59,59,59,59,59,
56,56,59,59,59,59,59,59,59,59,59,59,59,59,59,59,
56,56,59,59,59,59,59,59,59,59,59,59,59,59,59,59,
56,56,59,59,59,59,59,59,59,59,59,59,59,59,59,59,
56,56,59,59,59,59,59,59,59,59,59,59,59,59,59,59,
56,56,59,59,59,59,59,59,59,59,59,59,59,59,59,59,
56,56,59,59,59,59,59,59,59,59,59,59,59,59,59,59,
56,56,38,38,38,38,38,59,59,38,38,38,38,38,38,38,
56,56,56,56,56,56,56,59,59,56,56,56,56,56,56,56


1
market

2
octorok-b 2 10 10 14 6
