62,62,62,62,62,62,62,3,3,62,62,62,62,62,62,62,
62,62,62,63,61,62,62,3,3,62,62,23,62,62,62,62,
62,62,63,3,3,3,3,3,3,3,3,3,3,61,62,62,
61,63,3,3,3,3,3,3,3,3,3,3,3,3,61,63,
3,3,3,3,3,26,3,3,3,3,26,3,3,3,3,3,
3,3,3,3,3,3,3,3,3,3,3,3,3,3,3,3,
3,3,3,3,3,26,3,3,3,3,26,3,3,3,3,3,
43,45,3,3,3,3,3,3,3,3,3,3,3,3,43,45,
62,62,45,3,3,3,3,3,3,3,3,3,3,43,62,62,
62,62,62,45,43,44,44,44,44,44,44,44,44,62,62,62,
62,62,62,62,62,62,62,62,62,62,62,62,62,62,62,62


1
market

7
fat_dog-o 2 3 7 13 3
octorok-b 3 10 7 6 8 1 5
octorok-b 1 12 4
octorok-b 1 1 4
