26,26,26,26,26,26,26,26,26,26,26,26,26,26,26,26,
26,26,26,26,26,26,26,26,26,26,26,26,26,26,26,26,
26,26,26,3,3,3,3,3,3,3,3,3,3,3,3,3,
26,26,26,3,3,3,3,3,3,3,3,3,3,3,3,3,
3,3,3,3,3,3,3,3,3,3,3,3,3,26,3,3,
3,3,3,3,3,3,3,3,3,3,3,3,3,3,3,3,
80,80,80,80,80,80,81,3,3,3,3,3,3,26,3,3,
98,98,98,98,98,98,99,3,3,3,3,3,3,3,3,3,
98,98,98,98,98,98,99,3,3,3,3,3,3,3,3,3,
98,98,98,98,98,98,99,3,3,3,3,26,26,26,3,26,
98,98,98,98,98,98,99,3,3,3,3,26,26,26,3,26

1
market

9
fat_dog-o 5 10 6 11 2 10 8 13 5 6 5
octorok-b 2 9 0 4 7
fat_dog-o 1 3 7
fat_dog-o 1 11 4
