26,26,26,26,26,26,26,26,26,26,26,26,26,26,26,26,
26,26,26,26,26,26,26,26,26,26,26,26,26,26,26,26,
26,26,26,3,3,3,3,3,3,3,3,3,3,3,3,3,
26,26,26,3,3,3,3,3,3,3,3,3,3,3,3,3,
3,3,3,3,3,3,3,3,3,3,3,3,3,26,3,3,
3,3,3,3,3,3,3,3,3,3,3,3,3,3,3,3,
80,80,80,80,80,80,81,3,3,3,3,3,3,26,3,3,
98,98,98,98,98,98,99,3,3,3,3,3,3,3,3,3,
98,98,98,98,98,98,99,3,3,3,3,3,3,3,3,3,
98,98,98,98,98,98,99,3,3,3,3,26,26,26,3,26,
98,98,98,98,98,98,99,3,3,3,3,26,26,26,3,26

