56,56,56,56,56,56,56,56,56,56,56,56,56,56,56,56,
56,56,56,56,56,56,56,56,56,56,56,56,57,55,56,56,
56,56,57,3,3,3,3,3,3,3,3,3,3,3,55,56,
56,57,3,3,3,3,40,41,42,3,3,3,3,3,3,56,
56,3,3,21,3,21,58,137,60,21,3,21,3,3,3,56,
56,3,3,3,3,3,3,3,3,3,3,3,3,3,3,56,
56,3,3,21,3,21,3,3,3,21,3,21,3,3,3,56,
56,39,3,3,3,3,3,3,3,3,3,3,3,3,3,56,
56,56,39,3,3,3,3,3,3,3,3,3,3,3,37,56,
56,56,56,38,38,38,38,19,38,38,38,38,38,38,56,56,
56,56,56,56,56,56,56,19,56,56,56,56,56,56,56,56

1
market

2
octorok-b 2 15 6 9 3
