56,56,56,56,56,56,56,19,56,56,56,56,56,56,56,56,
56,56,56,56,56,56,56,19,56,56,56,56,56,56,56,56,
56,56,57,3,3,3,3,3,3,3,3,3,3,55,56,56,
56,56,3,3,3,2,3,3,3,3,3,3,3,3,56,56,
56,57,3,2,3,3,3,3,2,3,2,3,3,3,55,56,
3,3,3,3,3,2,3,3,3,3,3,3,2,3,3,3,
38,39,3,2,3,3,3,3,2,3,2,3,3,3,37,38,
56,56,3,3,3,2,3,3,3,3,3,3,3,3,56,56,
56,56,39,3,3,3,3,3,3,3,3,3,3,37,56,56,
56,56,56,38,38,38,38,19,38,38,38,38,38,56,56,56,
56,56,56,56,56,56,56,19,56,56,56,56,56,56,56,56

1
market
