56,56,56,56,56,56,56,19,56,56,56,56,56,56,56,56,
56,56,56,56,56,56,56,19,56,56,56,56,56,56,56,56,
59,59,59,59,59,59,59,59,59,59,59,59,59,59,59,59,
59,59,59,59,59,59,59,59,59,59,59,59,59,59,59,59,
59,59,59,59,59,59,59,59,59,59,59,59,59,59,59,59,
59,59,59,59,59,59,59,59,59,59,59,59,59,59,59,59,
59,59,59,59,59,59,59,59,59,59,59,59,59,59,59,59,
59,59,59,59,59,59,59,59,59,59,59,59,59,59,59,59,
59,59,59,59,59,59,59,59,59,59,59,59,59,59,59,59,
38,59,59,59,59,59,59,59,59,59,59,59,59,59,38,38,
56,59,59,59,59,59,59,59,59,59,59,59,59,59,56,56


1
market

4
fat_dog-o 4 1 5 2 7 5 5 14 8
