56,59,59,59,59,59,59,59,59,59,59,59,59,59,56,56,
56,59,59,59,59,59,59,59,59,59,59,59,59,59,56,56,
59,59,59,59,59,59,59,59,59,59,59,59,59,59,56,56,
59,59,59,59,59,59,59,59,59,59,59,59,59,59,56,56,
59,59,59,59,59,59,59,59,59,59,59,59,59,59,56,56,
59,59,59,59,59,59,59,59,59,59,59,59,59,59,56,56,
59,59,59,59,59,59,59,59,59,59,59,59,59,59,56,56,
59,59,59,59,59,59,59,59,59,59,59,59,59,59,56,56,
59,59,59,59,59,59,59,59,59,59,59,59,59,59,56,56,
38,38,38,38,38,38,38,38,38,38,38,38,59,59,56,56,
56,56,56,56,56,56,56,56,56,56,56,56,59,59,56,56

1
market

9
octorok-b 5 8 4 7 4 14 6 6 6 8 7
octorok-b 4 14 4 6 4 9 11 1 4
