56,59,59,59,59,59,59,59,59,59,59,59,59,59,56,56,
56,59,59,59,59,59,59,59,59,59,59,59,59,59,56,56,
59,59,59,59,59,59,59,59,59,59,59,59,59,59,56,56,
59,59,59,59,59,59,59,59,59,59,59,59,59,59,56,56,
59,59,59,59,59,59,59,59,59,59,59,59,59,59,56,56,
59,59,59,59,59,59,59,59,59,59,59,59,59,59,56,56,
59,59,59,59,59,59,59,59,59,59,59,59,59,59,56,56,
59,59,59,59,59,59,59,59,59,59,59,59,59,59,56,56,
59,59,59,59,59,59,59,59,59,59,59,59,59,59,56,56,
38,38,38,38,38,38,38,38,38,38,38,38,59,59,56,56,
56,56,56,56,56,56,56,56,56,56,56,56,59,59,56,56

1
market

4
fat_dog-o 1 11 3
fat_dog-o 1 11 9
octorok-b 1 6 7
fat_dog-o 1 8 6
