26,26,26,26,26,26,26,26,26,26,26,26,3,3,26,26,
26,26,26,26,26,26,26,26,26,26,26,26,3,3,26,26,
26,3,3,3,3,3,3,3,3,3,26,26,3,3,26,26,
26,3,3,3,3,3,26,3,3,3,26,26,3,3,26,26,
3,3,3,3,3,3,3,3,26,3,26,26,3,3,26,26,
3,3,26,3,3,3,26,3,3,3,26,26,3,3,26,26,
3,3,3,3,3,3,3,3,26,3,26,26,3,3,26,26,
26,3,3,3,3,3,26,3,3,3,26,26,3,3,26,26,
26,3,3,3,3,3,3,3,3,3,26,26,3,3,26,26,
26,3,26,3,3,3,26,3,26,3,26,26,3,3,26,26,
26,3,26,3,3,3,26,3,26,3,26,26,3,3,26,26

1
market

3
fat_dog-o 1 10 2
octorok-b 2 5 4 4 5
