26,3,26,3,3,3,26,3,26,3,26,26,3,3,26,26,
26,3,26,3,3,3,26,3,26,3,26,26,3,3,26,26,
3,3,3,3,3,3,3,3,3,3,3,3,3,3,3,3,
3,3,3,3,3,3,3,3,3,3,26,3,3,3,3,26,
3,3,26,3,3,3,26,3,26,3,3,3,3,3,3,26,
3,3,3,3,3,3,3,3,3,3,26,3,3,3,3,26,
3,3,26,3,3,3,26,3,26,3,3,3,3,3,3,26,
3,3,3,3,3,3,3,3,3,3,26,3,3,3,3,26,
3,3,3,3,3,3,3,3,3,3,3,3,3,3,3,3,
26,3,26,3,3,3,26,3,26,3,26,26,3,26,26,26,
26,3,26,3,3,3,26,3,26,3,26,26,3,26,26,26


1
market

6
octorok-b 2 2 7 12 4
octorok-b 2 13 6 2 8
octorok-b 1 4 5
octorok-b 1 14 5
