26,3,26,3,3,3,26,3,26,3,26,26,3,26,26,26,
26,3,26,3,3,3,26,3,26,3,26,26,3,26,26,26,
3,3,3,3,3,3,3,3,3,3,3,3,3,3,26,26,
3,3,3,3,3,3,3,3,3,3,26,3,3,3,3,26,
3,3,26,3,3,3,26,3,26,3,3,3,3,3,3,3,
3,3,3,3,3,3,3,3,3,3,26,3,3,3,3,3,
3,3,26,3,3,3,26,3,26,3,3,3,3,3,3,3,
3,3,3,3,3,3,3,3,3,3,26,3,3,3,3,26,
3,3,3,3,3,3,3,3,3,3,3,3,3,3,26,26,
26,26,26,26,26,26,26,26,26,26,26,3,3,3,26,26,
26,26,26,26,26,26,26,26,26,26,26,3,3,3,26,26

1
market

6
fat_dog-o 6 12 5 16 5 11 9 12 5 16 6 2 3
