56,56,56,56,56,56,56,56,56,56,56,3,3,3,56,56,
56,56,56,56,56,56,56,56,56,56,56,3,3,3,56,56,
56,56,56,56,56,56,57,3,3,3,3,3,3,3,3,3,
56,56,56,56,56,57,3,3,3,3,3,3,3,3,3,3,
56,57,55,56,57,3,3,3,3,3,3,3,3,3,3,3,
3,3,3,3,3,3,3,3,3,3,3,3,3,3,3,3,
38,39,37,38,39,3,3,73,74,74,74,74,74,74,74,74,
56,56,56,56,56,39,3,91,92,92,92,92,92,92,92,92,
56,56,56,56,56,56,39,91,92,92,92,92,92,92,92,92,
56,56,56,56,56,56,56,91,92,92,92,92,92,92,92,92,
56,56,56,56,56,56,56,91,92,92,92,92,92,92,92,92

1
market

9
fat_dog-o 2 2 6 14 11
fat_dog-o 7 13 8 10 8 3 6 12 9 10 6 7 8 12 11
