56,56,56,56,56,56,56,56,56,56,56,3,3,3,56,56,
56,56,56,56,56,56,56,56,56,137,56,3,3,3,56,56,
56,56,56,56,56,56,57,3,3,3,3,3,3,3,3,3,
56,56,56,56,56,57,3,3,3,3,3,3,3,3,3,3,
56,57,55,56,57,3,3,3,3,3,3,3,3,3,3,3,
3,3,3,3,3,3,3,3,3,3,3,3,3,3,3,3,
38,39,37,38,39,3,3,73,74,74,74,74,74,74,74,74,
56,56,56,56,56,39,3,91,92,92,92,92,92,92,92,92,
56,56,56,56,56,56,39,91,92,92,92,92,92,92,92,92,
56,56,56,56,56,56,56,91,92,92,92,92,92,92,92,92,
56,56,56,56,56,56,56,91,92,92,92,92,92,92,92,92


1
market

5
fat_dog-o 3 13 10 11 9 10 6
octorok-b 1 13 8
fat_dog-o 1 8 6
