56,56,56,56,56,56,56,56,56,56,56,56,56,56,56,56,
56,56,56,56,56,56,56,56,23,56,57,55,56,56,56,56,
56,56,56,56,56,56,56,57,3,3,3,3,56,56,57,3,
56,56,56,56,56,56,56,3,3,3,3,3,55,57,3,3,
56,56,56,56,56,56,57,3,3,3,3,3,3,3,3,3,
56,56,56,56,56,3,3,3,3,3,3,3,3,3,3,3,
56,56,56,56,56,19,39,3,3,3,3,3,3,3,3,3,
56,56,56,56,56,19,56,3,3,3,3,3,37,39,3,3,
56,56,56,56,56,19,56,39,3,3,3,3,56,56,39,3,
56,56,56,56,56,19,56,56,38,38,39,37,56,56,56,38,
56,56,56,56,56,19,56,56,56,56,56,56,56,56,56,56


1
market

10
octorok-b 3 11 6 14 6 7 4
fat_dog-o 5 7 5 9 5 7 5 10 4 11 4
fat_dog-o 1 9 3
fat_dog-o 1 8 8
