56,56,56,56,56,19,56,56,56,56,56,56,56,56,56,56,
56,56,56,56,56,19,56,56,56,56,56,56,56,56,56,56,
56,57,3,3,3,3,3,3,3,3,3,3,3,3,3,3,
56,3,3,3,3,3,3,3,3,3,3,3,3,3,3,3,
57,3,3,3,3,3,3,21,3,21,3,21,3,21,3,3,
3,3,3,3,3,3,3,3,3,3,3,3,3,3,3,3,
39,3,3,3,3,3,3,21,3,21,3,21,3,21,3,3,
56,3,3,3,3,3,3,3,3,3,3,3,3,3,3,3,
56,39,3,3,3,3,3,3,3,3,3,3,3,3,3,3,
56,56,38,19,38,38,38,38,38,38,38,38,38,38,38,38,
56,56,56,19,56,56,56,56,56,56,56,56,56,56,56,56

1
market

1
octorok-b 1 3 4
