56,56,56,19,56,56,56,56,56,56,56,56,56,56,56,56,
56,56,56,19,56,56,56,56,56,56,56,56,56,56,56,56,
3,3,3,3,3,3,3,3,3,3,3,3,56,56,56,56,
3,3,3,3,3,3,37,56,56,39,3,3,56,56,56,56,
3,3,3,3,3,37,56,56,56,56,39,3,55,56,56,56,
3,3,3,3,3,56,56,56,56,56,56,3,3,3,3,3,
3,3,3,3,3,55,56,56,56,56,57,3,3,3,3,3,
3,3,3,3,3,3,3,3,3,3,3,3,3,3,3,3,
3,3,3,3,3,3,3,3,3,3,3,3,3,3,3,3,
38,38,38,38,38,38,38,38,38,38,38,38,38,38,38,38,
56,56,56,56,56,56,56,56,56,56,56,56,56,56,56,56

1
market

7
octorok-b 2 13 2 11 8
fat_dog-o 2 8 3 8 2
octorok-b 1 5 7
octorok-b 2 2 5 5 7
