62,62,62,62,62,62,62,62,62,62,62,62,62,62,62,62,
62,62,62,62,62,62,62,62,62,62,62,62,63,61,62,62,
62,62,63,3,3,3,3,3,3,3,3,3,3,3,61,62,
62,63,3,3,3,3,46,47,48,3,3,3,3,3,3,62,
62,3,3,27,3,27,64,137,66,27,3,27,3,3,3,62,
62,3,3,3,3,3,3,3,3,3,3,3,3,3,3,62,
62,3,3,27,3,27,3,3,3,27,3,27,3,3,3,62,
62,45,3,3,3,3,3,3,3,3,3,3,3,3,3,62,
62,62,45,3,3,3,3,3,3,3,3,3,3,3,43,62,
62,62,62,44,44,44,44,25,44,44,44,44,44,44,62,62,
62,62,62,62,62,62,62,25,62,62,62,62,62,62,62,62

1
market

3
octorok-b 1 2 6
octorok-b 1 3 7
fat_dog-o 1 9 9
