62,62,62,62,62,62,62,25,62,62,62,62,62,62,62,62,
62,62,63,61,63,61,62,25,62,62,62,63,61,62,62,62,
62,62,3,3,3,3,62,25,62,62,62,3,3,62,62,62,
62,63,3,3,3,3,62,25,62,62,62,3,3,62,62,62,
62,3,3,3,3,3,61,25,62,62,63,3,3,61,62,63,
62,3,3,3,3,3,3,3,3,3,3,3,3,3,3,3,
62,3,3,3,3,3,3,3,3,3,3,3,3,43,44,45,
62,45,3,3,3,3,3,3,3,3,3,3,3,62,62,62,
62,62,3,3,3,3,3,3,3,3,3,3,3,62,62,62,
62,62,45,43,45,43,44,44,44,44,44,45,43,62,62,62,
62,62,62,62,62,62,62,62,62,62,62,62,62,62,62,62

