26,26,26,26,26,26,26,26,26,26,26,26,26,26,26,26,
26,26,26,26,26,26,26,26,26,26,26,26,26,26,26,26,
3,3,3,3,3,3,3,3,3,3,3,3,3,26,26,26,
26,26,26,26,26,26,26,26,26,26,26,26,3,26,26,26,
26,26,26,26,26,26,26,26,26,26,26,26,3,3,3,3,
26,26,26,26,26,26,26,26,26,26,26,26,3,3,3,3,
26,26,26,26,26,26,26,26,26,26,26,26,3,3,3,3,
26,26,26,26,26,26,26,26,26,26,26,26,3,26,26,26,
3,3,3,3,3,26,26,26,26,26,26,26,3,26,26,26,
26,26,26,26,3,26,26,26,26,26,26,26,3,26,26,26,
26,26,26,26,3,26,26,26,26,26,26,26,3,26,26,26

1
market

3
fat_dog-o 3 13 6 5 2 16 6
