56,56,56,56,56,56,56,56,56,56,56,56,56,56,56,56,
56,56,56,56,56,56,56,56,56,56,56,56,56,56,56,56,
56,56,3,3,3,3,3,3,3,3,3,3,3,3,56,56,
56,56,3,3,3,3,3,3,3,3,3,3,3,3,56,56,
56,56,3,3,3,3,3,3,3,3,3,3,3,3,56,56,
56,56,3,3,3,3,3,3,3,3,3,3,3,3,56,56,
56,56,3,3,3,3,3,3,3,3,3,3,3,3,56,56,
56,56,3,3,3,3,3,3,3,3,3,3,3,3,56,56,
56,56,3,3,3,3,3,3,3,3,3,3,3,3,56,56,
56,56,38,38,38,38,38,3,3,38,38,38,38,38,56,56,
56,56,56,56,56,56,56,3,3,56,56,56,56,56,56,56

1
market
