56,56,56,56,56,56,56,56,56,56,56,56,56,19,56,56,
56,56,56,56,56,56,56,56,56,56,56,56,56,19,56,56,
3,3,3,3,55,56,56,56,56,56,56,56,56,19,56,56,
3,3,3,3,3,56,56,56,56,56,57,55,56,19,56,56,
3,3,3,3,3,56,56,56,56,56,3,3,3,3,3,3,
3,3,3,2,3,56,57,3,3,3,3,3,3,3,3,3,
3,3,3,3,3,56,3,3,3,73,74,74,74,74,74,74,
3,3,3,3,3,56,3,3,3,91,92,92,92,92,92,92,
3,3,3,3,37,56,39,3,3,91,92,92,92,92,92,92,
38,38,19,38,56,56,56,3,3,91,92,92,92,92,92,92,
56,56,19,56,56,56,56,3,3,91,92,92,92,92,92,92

1
market

3
octorok-b 2 4 7 3 8
octorok-b 1 7 3
