56,56,19,56,56,56,56,3,3,91,92,92,92,92,92,92,
56,56,19,56,56,137,57,3,3,91,92,92,92,92,92,92,
56,56,19,56,3,3,3,3,3,91,92,92,92,92,92,92,
56,56,19,56,3,3,3,3,3,91,92,92,92,92,92,92,
56,56,19,57,3,3,3,3,3,109,110,110,110,110,110,110,
3,3,3,3,3,3,3,3,3,3,3,3,3,3,3,3,
3,3,3,3,3,3,3,3,3,3,3,3,3,3,3,3,
3,3,3,3,3,3,3,3,3,3,3,3,3,3,3,3,
3,3,3,3,3,3,3,3,3,3,3,3,3,3,3,3,
38,38,38,38,38,38,38,3,3,38,38,38,38,38,38,38,
56,56,56,56,56,56,56,3,3,56,56,56,56,56,56,56


1
market

7
octorok-b 3 5 2 7 2 9 5
fat_dog-o 4 7 3 8 4 0 2 6 7
