26,26,26,26,26,26,26,3,3,26,26,26,26,26,26,26,
26,26,26,26,26,26,26,3,3,26,26,26,26,26,26,26,
26,3,3,3,3,3,3,3,3,3,3,3,3,3,3,26,
26,3,26,3,26,3,3,3,3,3,3,26,3,3,3,26,
26,3,3,3,3,3,27,3,3,27,3,3,3,26,3,26,
26,3,26,3,26,3,3,3,3,3,3,26,3,3,3,26,
26,3,3,3,3,3,3,3,3,3,3,3,3,26,3,26,
26,3,26,3,26,3,3,3,3,3,3,26,3,3,3,26,
26,3,3,3,3,3,3,3,3,3,3,3,3,3,3,26,
26,3,26,3,26,3,26,3,3,26,3,26,3,26,3,26,
26,3,26,3,26,3,26,3,3,26,3,26,3,26,3,26

1
market

2
octorok-b 2 7 4 11 7
