26,26,26,3,26,26,26,26,26,26,26,26,3,26,26,26,
26,26,26,3,26,26,26,26,26,26,26,26,3,26,26,26,
26,26,26,3,26,26,26,26,26,26,26,26,3,26,26,26,
26,26,26,3,26,26,26,26,26,26,26,26,3,26,26,26,
3,3,3,3,3,3,3,3,3,3,3,3,3,3,3,3,
3,3,3,3,3,3,3,3,3,3,3,3,3,3,3,3,
3,3,3,3,3,3,3,3,3,3,3,3,3,3,3,3,
26,26,26,3,26,26,26,26,26,26,26,26,3,26,26,26,
26,26,26,3,26,26,26,26,26,26,26,26,3,26,26,26,
26,26,26,3,26,26,26,26,26,26,26,26,3,26,26,26,
26,26,26,3,26,26,26,26,26,26,26,26,3,26,26,26

1
market

1
octorok-b 1 12 7
