26,26,26,3,26,26,26,26,26,26,26,26,3,26,26,26,
26,26,26,3,26,26,26,26,26,26,26,26,3,26,26,26,
3,3,3,3,3,3,3,3,3,3,26,3,3,26,26,26,
26,26,3,3,26,26,26,26,26,26,26,26,3,26,26,26,
26,26,3,3,26,26,26,26,26,26,26,26,3,3,3,3,
26,26,3,3,26,26,26,26,26,26,26,26,3,3,3,3,
26,26,3,3,26,26,26,26,26,26,26,26,3,3,3,3,
26,26,3,3,26,26,26,26,26,26,26,26,26,26,26,26,
3,3,3,3,26,26,26,26,26,26,26,26,26,26,26,26,
26,26,26,26,26,26,26,26,26,26,26,26,26,26,26,26,
26,26,26,26,26,26,26,26,26,26,26,26,26,26,26,26

1
market

8
octorok-b 7 12 6 12 8 12 4 12 10 3 4 2 8 1 8
fat_dog-o 1 2 4
