92,92,92,92,92,92,92,92,92,92,92,92,92,92,92,92,
92,92,92,92,92,92,92,92,92,92,92,92,92,92,92,92,
92,92,92,92,92,92,92,92,92,92,92,92,92,92,92,92,
56,56,56,56,56,56,56,56,56,56,92,92,92,92,92,92,
56,56,56,56,56,137,56,56,56,56,92,92,92,92,92,92,
56,56,56,56,56,3,56,56,56,56,92,92,92,92,92,92,
56,56,56,56,56,3,56,56,56,56,92,92,92,92,92,92,
56,56,56,56,56,3,56,56,56,56,92,92,92,92,92,92,
56,56,56,56,56,19,56,56,56,56,92,92,92,92,92,92,
56,56,56,56,56,19,56,56,56,56,92,92,92,92,92,92,
56,56,56,56,56,19,56,56,56,56,92,92,92,92,92,92


1
market

8
fat_dog-o 2 5 3 5 5
octorok-b 5 5 4 5 3 5 3 5 5 5 5
octorok-b 1 5 4
