56,56,56,56,56,19,56,56,56,56,56,56,56,56,56,56,
56,56,56,56,56,19,56,56,56,56,56,56,56,56,56,56,
56,56,56,56,56,19,56,56,56,57,3,3,3,3,3,3,
56,56,56,56,56,19,56,56,56,3,3,3,3,3,3,3,
3,3,3,3,3,3,3,56,56,3,3,3,3,3,3,3,
3,3,3,3,3,3,3,3,3,3,3,3,3,3,3,3,
74,74,74,74,74,74,74,56,56,3,3,3,3,3,3,3,
92,92,92,92,92,92,92,56,56,3,3,3,3,3,3,3,
92,92,92,92,92,92,92,56,56,3,3,3,3,3,3,3,
92,92,92,92,92,92,92,56,56,38,38,38,38,38,38,38,
92,92,92,92,92,92,92,56,56,56,56,56,56,56,56,56

