56,56,3,3,3,3,3,3,3,91,92,92,92,92,92,92,
56,56,3,3,3,3,3,3,3,91,92,92,92,92,92,92,
56,56,3,3,3,3,3,3,3,91,92,92,92,92,92,92,
56,56,3,3,3,3,3,3,3,91,92,92,92,92,92,92,
56,56,3,3,3,3,3,3,3,109,110,110,110,110,110,110,
56,56,3,3,3,3,3,3,3,3,3,3,3,3,3,3,
56,56,3,3,3,3,3,3,3,3,3,3,3,3,3,3,
56,56,3,3,3,3,3,3,3,3,3,3,3,3,3,3,
56,56,39,3,3,3,3,3,3,3,3,3,3,3,3,3,
56,56,56,38,38,38,38,38,38,38,38,38,38,38,38,38,
56,56,56,56,56,56,56,56,56,56,56,56,56,56,56,56

1
market

5
octorok-b 1 7 9
fat_dog-o 3 6 9 7 3 8 8
fat_dog-o 1 5 4
