26,26,26,26,26,26,26,26,26,26,26,26,26,26,26,26,
26,26,26,26,26,26,26,26,26,26,26,26,26,26,26,26,
26,26,3,3,3,3,3,3,3,3,3,3,3,3,26,26,
26,3,3,3,3,3,3,3,3,3,3,3,3,3,3,26,
3,3,3,3,3,27,3,3,3,3,27,3,3,3,3,26,
3,3,3,3,3,3,3,3,3,3,3,3,3,3,3,26,
3,3,3,3,3,3,3,3,3,3,3,3,3,3,3,26,
26,3,3,3,3,3,3,3,3,3,3,3,3,3,3,26,
26,26,3,3,3,3,3,3,3,3,3,3,3,3,26,26,
26,26,26,26,26,26,26,26,26,26,26,26,26,26,26,26,
26,26,26,26,26,26,26,26,26,26,26,26,26,26,26,26

1
market

7
octorok-b 7 3 4 6 9 12 8 6 9 10 8 2 6 2 5
