62,62,62,62,62,62,62,62,62,62,62,62,62,62,62,62,
62,62,62,62,62,63,61,137,62,62,62,62,62,62,62,62,
62,63,3,3,3,3,3,3,61,62,62,63,3,3,61,62,
63,3,3,3,3,3,3,3,3,61,63,3,3,3,3,62,
3,3,3,3,26,3,3,3,3,3,3,3,26,3,3,62,
3,3,3,3,3,3,3,3,3,3,3,3,3,3,3,62,
3,3,3,3,26,3,3,3,3,3,3,3,26,3,3,62,
45,3,3,3,3,3,3,3,3,43,45,3,3,3,3,62,
62,45,3,3,3,3,3,3,43,62,62,45,3,3,43,62,
62,62,44,44,44,45,43,44,62,62,62,62,44,44,62,62,
62,62,62,62,62,62,62,62,62,62,62,62,62,62,62,62

1
market

5
octorok-b 1 6 8
fat_dog-o 4 2 8 5 7 2 5 12 7
