62,62,62,62,62,62,62,62,62,62,62,62,62,62,62,62,
62,62,62,62,62,63,61,23,62,62,62,62,62,62,62,62,
62,63,3,3,3,3,3,3,61,62,62,63,3,3,61,62,
63,3,3,3,3,3,3,3,3,61,63,3,3,3,3,62,
3,3,3,3,26,3,3,3,3,3,3,3,26,3,3,62,
3,3,3,3,3,3,3,3,3,3,3,3,3,3,3,62,
3,3,3,3,26,3,3,3,3,3,3,3,26,3,3,62,
45,3,3,3,3,3,3,3,3,43,45,3,3,3,3,62,
62,45,3,3,3,3,3,3,43,62,62,45,3,3,43,62,
62,62,44,44,44,45,43,44,62,62,62,62,44,44,62,62,
62,62,62,62,62,62,62,62,62,62,62,62,62,62,62,62


1
market

7
octorok-b 2 13 4 6 8
fat_dog-o 3 12 5 6 6 1 3
fat_dog-o 1 13 4
octorok-b 1 13 2
