26,26,26,26,26,26,26,26,26,26,26,26,26,26,26,26,
26,26,26,26,26,26,26,26,26,26,26,26,26,26,26,26,
26,26,3,3,3,3,3,3,3,3,3,3,3,3,3,3,
26,3,3,26,26,26,3,3,3,3,3,3,3,3,3,3,
3,3,3,3,3,3,3,3,3,3,26,26,26,26,3,3,
3,3,3,26,26,26,3,26,26,3,3,3,3,3,3,3,
3,3,3,3,3,3,3,3,3,3,26,26,26,26,3,3,
26,3,3,26,26,26,3,3,3,3,3,3,3,3,3,3,
26,26,3,3,3,3,3,3,3,3,3,3,3,3,3,3,
26,26,26,26,26,26,26,26,26,26,26,26,26,26,26,26,
26,26,26,26,26,26,26,26,26,26,26,26,26,26,26,26


1
market

4
fat_dog-o 3 5 2 6 4 0 5
octorok-b 1 8 2
