92,56,56,56,56,56,56,56,56,56,56,56,56,56,56,92,
92,56,56,56,56,56,56,56,56,56,56,56,56,56,56,92,
92,56,3,3,3,3,3,3,3,3,3,3,3,3,56,92,
92,56,3,3,40,42,3,40,41,42,3,40,42,3,56,92,
92,56,3,3,58,60,3,58,137,60,3,58,60,3,56,92,
92,56,3,3,3,3,3,3,3,3,3,3,3,3,56,92,
92,56,3,3,3,3,3,3,3,3,3,3,3,3,56,92,
92,56,3,3,3,3,3,3,3,3,3,3,3,3,56,92,
92,56,3,3,3,3,3,3,3,3,3,3,3,3,56,92,
92,56,38,38,38,38,38,38,19,38,38,38,38,38,56,92,
92,56,56,56,56,56,56,56,19,56,56,56,56,56,56,92


1
dungeon

6
fat_dog-o 1 12 5
octorok-b 1 4 2
octorok-b 1 11 5
octorok-b 1 13 6
octorok-b 1 2 2
fat_dog-o 1 8 5
