56,56,56,56,56,56,56,56,19,56,56,56,56,56,56,92,
56,56,56,56,56,56,56,56,19,56,56,56,56,56,56,92,
3,3,3,3,3,3,3,3,3,3,3,3,3,3,56,92,
3,3,10,12,3,10,11,12,3,3,10,12,3,3,56,92,
3,3,28,30,3,28,137,30,3,3,28,30,3,3,56,92,
3,3,3,3,3,3,3,3,3,3,3,3,3,3,56,92,
3,3,3,3,10,12,3,3,10,12,3,10,12,3,56,92,
3,3,3,3,28,30,3,3,28,30,3,28,30,3,56,92,
3,3,3,3,3,3,3,3,3,3,3,3,3,3,56,92,
38,38,38,38,38,38,38,38,38,38,38,38,38,38,56,92,
56,56,56,56,56,56,56,56,56,56,56,56,56,56,56,92


1
dungeon

7
octorok-b 5 10 8 13 2 0 5 9 6 1 6
fat_dog-o 1 9 6
fat_dog-o 1 3 8
