56,56,56,56,56,3,3,3,3,91,92,92,92,92,92,92,
56,56,56,56,57,3,3,3,3,91,92,92,92,92,92,92,
56,56,56,56,3,3,3,3,3,91,92,92,92,92,92,92,
56,56,56,56,3,3,3,3,3,91,92,92,92,92,92,92,
56,56,56,57,3,3,3,3,3,91,92,92,92,92,92,92,
56,56,57,3,3,3,3,3,3,91,132,92,132,92,92,92,
56,56,3,3,3,3,3,3,3,91,92,92,92,92,92,92,
56,56,3,3,3,3,3,3,3,91,92,92,92,92,92,92,
56,56,39,3,3,3,3,3,3,91,92,92,92,92,92,92,
56,56,56,38,39,3,3,3,3,91,92,92,92,92,92,92,
56,56,56,56,56,3,3,3,3,91,92,92,92,92,92,92

1
market

1
octorok-b 1 6 8
