56,56,56,56,56,3,3,3,3,91,92,92,92,92,92,92,
55,56,56,137,57,3,3,3,3,91,92,92,92,92,92,92,
3,3,3,3,3,3,3,3,3,91,92,92,92,92,92,92,
3,3,3,3,3,3,3,3,3,91,92,92,92,92,92,92,
3,3,3,3,3,3,3,3,3,91,92,92,92,92,92,92,
3,3,3,3,3,3,3,3,3,91,92,92,92,92,92,92,
3,3,3,3,3,3,3,3,3,91,92,92,92,92,92,92,
3,3,3,3,3,3,3,3,3,91,92,92,92,92,92,92,
3,3,3,3,3,3,3,3,3,91,92,92,92,92,92,92,
37,38,38,38,39,3,3,3,3,91,92,92,92,92,92,92,
56,56,56,56,56,3,3,3,3,91,92,92,92,92,92,92

1
market

3
fat_dog-o 2 3 4 4 3
octorok-b 1 1 4
