3,3,3,3,3,3,3,3,3,3,3,3,3,3,3,62,
3,3,3,3,3,3,3,3,3,3,3,3,3,3,3,62,
3,3,3,3,3,3,3,3,3,3,3,3,3,3,3,62,
3,3,3,3,3,3,3,3,3,3,3,3,3,3,3,62,
3,3,3,3,3,3,3,3,3,3,3,3,3,3,3,62,
3,3,3,3,3,3,3,3,3,3,3,3,3,3,3,62,
3,3,3,3,3,3,3,3,3,3,3,3,3,3,3,62,
3,3,3,3,3,3,3,3,3,3,3,3,3,3,3,62,
3,3,3,3,3,3,3,3,3,3,3,3,3,3,3,62,
3,3,3,3,3,3,3,3,3,3,3,3,3,3,43,62,
44,44,44,44,44,44,44,44,44,44,44,44,44,44,44,62
