56,56,56,56,56,3,3,3,3,91,92,92,92,92,92,92,
56,56,56,56,56,3,3,3,3,91,92,92,92,92,92,92,
56,56,56,56,56,3,3,3,3,91,92,92,92,92,92,92,
57,55,56,56,57,3,3,3,3,91,92,92,92,92,92,92,
3,3,3,3,3,3,3,3,3,91,92,92,92,92,92,92,
3,3,3,3,3,3,3,3,130,92,92,92,92,92,92,92,
74,74,74,74,74,74,74,74,92,92,92,92,92,92,92,92,
92,92,92,92,92,92,92,92,92,92,92,92,92,92,92,92,
92,92,92,92,92,92,92,92,92,92,92,92,92,92,92,92,
92,92,92,92,92,92,92,92,92,92,92,92,92,92,92,92,
92,92,92,92,92,92,92,92,92,92,92,92,92,92,92,92


1
market

5
fat_dog-o 4 7 10 3 5 6 10 6 10
fat_dog-o 1 5 10
