56,56,56,56,56,3,3,3,3,3,3,3,91,92,92,92,
56,56,56,56,56,3,3,3,3,3,3,3,91,92,92,92,
56,56,56,56,56,3,3,3,3,3,3,3,91,92,92,92,
57,55,56,56,57,3,3,3,3,3,3,3,91,92,92,92,
3,3,3,3,3,3,3,3,3,3,3,3,91,92,92,92,
3,3,3,3,3,3,3,3,3,3,3,136,92,92,92,92,
74,74,74,74,74,74,74,74,74,74,74,98,92,92,92,92,
92,92,92,92,92,92,92,92,92,92,92,92,92,92,92,92,
92,92,92,92,92,92,92,92,92,92,92,92,92,92,92,92,
92,92,92,92,92,92,92,92,92,92,92,92,92,92,92,92,
92,92,92,92,92,92,92,92,92,92,92,92,92,92,92,92

1
market

3
octorok-b 1 5 9
octorok-b 1 9 6
fat_dog-o 1 6 7
