56,56,56,56,19,56,56,56,56,56,56,56,56,56,56,56,
57,55,56,56,19,56,56,56,56,56,56,56,56,56,56,56,
3,3,55,56,19,56,56,56,56,56,56,56,56,56,56,56,
3,3,3,56,19,56,56,56,56,56,56,56,56,56,56,56,
3,3,3,55,19,56,73,74,74,74,74,74,74,74,74,74,
3,3,3,3,3,3,92,3,3,3,3,3,3,3,3,3,
3,3,3,3,3,3,92,3,3,3,3,3,3,3,3,3,
3,3,3,3,3,3,92,3,3,3,3,3,3,3,3,3,
3,3,3,3,3,3,92,3,3,3,3,3,3,3,3,3,
38,38,38,38,38,39,92,3,3,3,3,37,38,38,38,38,
56,56,56,56,56,56,92,3,3,3,3,56,56,56,56,56
