56,56,56,56,56,56,92,3,3,3,3,56,56,56,56,56,
56,56,56,56,56,56,92,3,3,3,3,56,56,56,23,56,
56,56,56,56,56,56,92,3,3,3,3,56,56,56,3,3,
55,56,57,55,56,57,92,3,3,3,3,55,56,57,3,3,
3,3,3,3,3,3,92,3,3,3,3,3,3,3,3,3,
3,3,3,3,3,130,92,129,3,3,3,3,3,3,3,3,
74,74,74,74,74,92,92,92,74,74,74,74,74,74,74,74,
92,92,92,92,92,92,92,92,92,92,92,92,92,92,92,92,
92,92,92,92,92,92,92,92,92,92,92,92,92,92,92,92,
92,92,92,92,92,92,92,92,92,92,92,92,92,92,92,92,
92,92,92,92,92,92,92,92,92,92,92,92,92,92,92,92
