62,62,26,3,26,3,26,3,3,26,3,26,3,26,3,26,
62,62,26,3,26,3,26,3,3,26,3,26,3,26,3,26,
62,63,3,3,3,3,3,3,3,3,3,3,3,3,3,3,
63,3,3,3,26,3,3,3,3,26,3,3,3,26,3,26,
9,3,26,3,3,3,3,3,3,3,3,3,3,3,3,3,
3,3,3,3,26,3,26,3,3,26,3,26,3,26,3,3,
3,3,26,3,3,3,3,3,3,3,3,3,3,3,3,3,
45,3,3,3,26,3,3,3,3,26,3,3,3,26,3,26,
62,45,3,3,3,3,3,3,3,3,3,3,3,3,3,26,
62,62,26,3,26,3,26,3,3,26,3,26,3,26,3,26,
62,62,26,3,26,3,26,3,3,26,3,26,3,26,3,26
