56,56,56,56,56,56,56,56,56,56,56,56,56,56,56,56,
56,56,56,56,56,56,56,56,56,56,56,56,56,56,56,56,
56,57,55,57,3,3,3,3,3,3,3,3,3,55,56,56,
56,3,3,3,3,3,2,3,3,3,3,3,3,3,55,56,
57,3,3,3,3,2,3,3,3,3,3,3,3,3,3,56,
3,3,3,3,2,3,2,3,2,3,2,3,2,3,3,56,
39,3,3,3,3,2,3,3,3,3,3,3,3,3,3,56,
56,3,3,3,3,3,2,3,3,3,3,3,3,3,37,56,
56,39,37,39,3,3,3,3,3,3,3,3,3,37,56,56,
56,56,56,56,38,38,38,38,38,38,38,38,38,56,56,56,
56,56,56,56,56,56,56,56,56,56,56,56,56,56,56,56

