56,56,56,56,56,56,56,56,56,56,56,56,56,56,56,56,
56,56,56,56,56,56,56,56,56,56,56,56,56,56,56,56,
56,57,3,3,3,3,3,3,3,3,3,3,3,3,55,56,
56,3,3,3,3,73,74,74,74,74,75,3,3,3,3,56,
56,3,3,26,3,91,92,92,92,92,93,3,26,3,3,56,
56,3,3,3,3,91,92,92,92,92,93,3,3,3,3,56,
56,3,3,26,3,109,110,110,110,110,111,3,26,3,3,56,
56,3,3,3,3,3,3,3,3,3,3,3,3,3,3,56,
56,39,3,3,3,3,3,3,3,3,3,3,3,3,37,56,
56,56,38,38,38,38,38,3,3,38,38,38,38,38,56,56,
56,56,56,56,56,56,56,3,3,56,56,56,56,56,56,56

