26,26,26,26,26,26,26,3,3,26,26,26,26,26,26,26,
26,26,26,26,26,26,26,3,3,26,26,26,26,26,26,26,
26,26,3,3,3,26,26,3,3,26,26,26,26,26,26,26,
26,26,3,3,3,26,26,3,3,26,26,26,26,26,26,26,
26,26,3,3,3,3,3,3,3,3,3,3,3,3,3,3,
26,26,3,8,3,3,3,3,3,3,3,3,3,3,3,3,
26,26,3,3,3,3,3,3,3,3,3,3,3,3,3,3,
26,26,3,3,3,26,26,3,3,26,26,26,26,26,26,26,
26,26,3,3,3,26,26,3,3,26,26,26,26,26,26,26,
26,26,26,26,26,26,26,3,3,26,26,26,26,26,26,26,
26,26,26,26,26,26,26,3,3,26,26,26,26,26,26,26

