98,98,98,98,98,98,99,3,3,3,3,26,26,26,3,26,
98,98,98,98,98,98,99,3,3,3,3,26,26,26,3,26,
98,98,98,98,98,98,99,3,3,3,3,3,3,3,3,3,
98,98,98,98,98,98,99,3,3,3,3,3,3,3,3,3,
116,116,116,116,116,116,117,3,3,3,3,3,3,26,3,3,
3,3,3,3,3,3,3,3,3,3,3,3,3,3,3,3,
3,3,3,3,3,3,3,3,3,3,3,3,3,26,3,3,
3,3,3,3,3,3,3,3,3,3,3,3,3,3,3,3,
3,3,3,3,3,3,3,3,3,3,3,3,3,3,3,3,
26,26,26,26,26,26,26,26,26,26,26,26,26,26,26,26,
26,26,26,26,26,26,26,26,26,26,26,26,26,26,26,26

