56,56,56,56,56,56,56,56,56,56,56,56,56,56,56,92,
56,56,56,56,56,56,56,56,56,56,56,56,56,56,56,92,
3,3,3,3,3,3,3,3,3,3,3,3,3,3,56,92,
3,3,10,12,3,10,11,12,3,3,10,12,3,3,56,92,
3,3,28,30,3,28,137,30,3,3,28,30,3,3,56,92,
3,3,3,3,3,3,3,3,3,3,3,3,3,3,56,92,
3,3,3,3,10,12,3,3,10,12,3,10,12,3,56,92,
3,3,3,3,28,30,3,3,28,30,3,28,30,3,56,92,
3,3,3,3,3,3,3,3,3,3,3,3,3,3,56,92,
38,38,38,38,38,38,38,38,38,38,38,38,38,38,56,92,
56,56,56,56,56,56,56,56,56,56,56,56,56,56,56,92

